1,Post Date,Check,Description,Debit,Credit,Status,Balance
1,2/27/2024,,NETFLIX.COM            NETFLIX.COM  CAUS,17.35,,Pending,
1,2/26/2024,,POS WD - AMZN Mktp US*RW8AH1922 Amzn.com/billWAUS,7.57,,Posted,1209.44
1,2/26/2024,,POS WD - AMZN Mktp US*RW4MT49G2 Amzn.com/billWAUS,32.43,,Posted,1217.01
1,2/26/2024,,POS WD - AMZN Mktp US*RZ66B7520 Amzn.com/billWAUS,22.71,,Posted,1249.44
1,2/25/2024,,POS WD - AMZN Mktp US*RW3LC0TY1 Amzn.com/billWAUS,16.79,,Posted,1272.15
1,2/25/2024,,POS WD - SQ *KEVA - NORTHWEST REReno         NVUS,16.76,,Posted,1288.94
1,2/25/2024,,POS WD - VZWRLSS*APOCC VISW     800-922-0204 FLUS,117.01,,Posted,1305.7
1,2/25/2024,,POS WD - ROSS STORES #855       RENO         NVUS,22.16,,Posted,1422.71
1,2/23/2024,,POS WD - TARGET T-1363 6845 Sierra Center PkwyReno         NVUS,55.51,,Posted,1444.87
1,2/23/2024,,POS WD - SAVE MART #554 RENO NV 4995 KIETZKE LANE      RENO         N,21.89,,Posted,1500.38
1,2/23/2024,,NOW Deposit - Zelle From MetGen - +1-800-421-6674,,221.24,Posted,1522.27
1,2/23/2024,,External WD - NV ENERGY NORTH SPPCO - SPPC PYMT,101.63,,Posted,1301.03
1,2/22/2024,,POS WD - Amazon.com*RW4P69RP0   Amzn.com/billWAUS,16.23,,Posted,1402.66
1,2/22/2024,,External WD - AMERICANEXPRESS PERSONAL SAVINGS - TRANSFER,133.34,,Posted,1418.89
1,2/22/2024,,External WD - PAYPAL INSTANT TRANSFER - INST XFER,30.98,,Posted,1552.23
1,2/22/2024,,POS WD - PORT OF SUBS 0010 ONLINolo.com      NVUS,9.2,,Posted,1583.21
1,2/21/2024,,POS WD - 7-ELEVEN 6150 S. Mccarran B US  Reno         NVUS,10.66,,Posted,1592.41
1,2/21/2024,,External DP - ASSIST-2-SELL IN WRS667 02761ASSIS001 - Payroll,,1559.1,Posted,1603.07
1,2/21/2024,,POS WD - AMZN Mktp US*RI9BM4QJ1 Amzn.com/billWAUS,22.72,,Posted,43.97
1,2/21/2024,,POS WD - DMV-44                 775-684-4513 NVUS,3.25,,Posted,66.69
1,2/20/2024,,POS WD - Roku for WarnerMedia Gl816-2728107  DEUS,9.99,,Posted,69.94
1,2/20/2024,,External WD - FARMERS INS  - EFT PYMT,17.21,,Posted,79.93
1,2/20/2024,,External WD - PAYPAL INSTANT TRANSFER - INST XFER,2.99,,Posted,97.14
1,2/20/2024,,External DP - VENMO  - CASHOUT,,50.82,Posted,100.13
1,2/17/2024,,POS WD - VENMO  *Adalyn Osentos Visa Direct  NYUS,28.99,,Posted,49.31
1,2/17/2024,,POS WD - DENTAL INSURANCE AUTOPA877-2804204  CAUS,31.3,,Posted,78.3
1,2/16/2024,,POS WD - Subway 10118           177-58297330 NVUS,9.62,,Posted,109.6
1,2/15/2024,,POS WD - VSP 800-785-0699       800-785-0699 TXUS,13.84,,Posted,119.22
1,2/13/2024,,External WD - PAYPAL INSTANT TRANSFER - INST XFER,29.99,,Posted,133.06
1,2/13/2024,,External DP - VENMO  - CASHOUT,,12.5,Posted,163.05
1,2/9/2024,,External DP - VENMO  - CASHOUT,,6,Posted,150.55
1,2/8/2024,,POS WD - STARBUCKS 800-782-7282 800-782-7282 WAUS,10,,Posted,144.55
1,2/7/2024,,POS WD - SAVE MART #554 RENO NV 4995 KIETZKE LANE      RENO         N,11.98,,Posted,154.55
1,2/7/2024,,POS WD - VCA ANIMAL 4792 CAUGHLIN PKWY US  RENO         NVUS,108.45,,Posted,166.53
1,2/6/2024,,POS WD - WINCO FOODS #12 9750 SOReno         NVUS,218.55,,Posted,274.98
1,2/6/2024,,POS WD - TARGET T-1363 6845 Sierra Center PkwyReno         NVUS,57.12,,Posted,493.53
1,2/6/2024,,Deposit - Shared Branch 6100 NEIL RD STE 150    RENO          NV,,59.95,Posted,550.65
1,2/6/2024,,POS WD - VENMO  *Kenny Holcomb  Visa Direct  NYUS,25,,Posted,490.7
1,2/6/2024,,External WD - DISCOVER DC PYMNTS DCIINTNET - E-PAYMENT,175,,Posted,515.7
1,2/6/2024,,POS WD - EQT* AETNA CVS HEALTH  844-3657373  CTUS,174.86,,Posted,690.7
1,2/5/2024,,External WD - AMERICANEXPRESS PERSONAL SAVINGS - TRANSFER,633.33,,Posted,865.56
1,2/5/2024,,Withdrawal - Internet Transfer to XXXXX0643 -  via Mobile,4.84,,Posted,1498.89
1,2/5/2024,,Withdrawal - Internet Transfer to XXXXX0643 -  via Mobile,3.34,,Posted,1503.73
1,2/5/2024,,Withdrawal - Internet Transfer to XXXXX0643 -  via Mobile,9.9,,Posted,1507.07
1,2/5/2024,,Withdrawal - Internet Transfer to XXXXX0643 -  via Mobile,1.85,,Posted,1516.97
1,2/5/2024,,Withdrawal - Internet Transfer to XXXXX0643 -  via Mobile,48.51,,Posted,1518.82
1,2/5/2024,,External DP - ASSIST-2-SELL IN WRS667 02761ASSIS001 - Payroll,,1559.1,Posted,1567.33
1,2/4/2024,,POS WD - METLIFE PET            HTTPSWWW.PETFINUS,44.36,,Posted,8.23
1,2/3/2024,,POS WD - DUTCH BROS             541-955-4700 ORUS,10,,Posted,52.59
1,2/2/2024,,External WD - GEICO  - PREM COLL,96,,Posted,62.59
1,2/1/2024,,POS WD - VENMO  *Adalyn Osentos Visa Direct  NYUS,93.88,,Posted,158.59
1,2/1/2024,,Deposit - Internet Transfer from XXXXX0643 -  via Mobile,,48.51,Posted,252.47
1,1/31/2024,,Descriptive Deposit - Cash Back Reward,,10,Posted,203.96
1,1/31/2024,,POS WD - COLD STONE CREAMERY #2 775-8138011  NVUS,6.54,,Posted,193.96
1,1/30/2024,,NOW Deposit - Zelle From IHC-Metlife Pet +1-800-421-6674,,53.66,Posted,200.5
1,1/28/2024,,POS WD - SQ *KEVA - NORTHWEST REReno         NVUS,16.76,,Posted,146.84
1,1/27/2024,,POS WD - IN-N-OUT RENO          RENO         NVUS,10.34,,Posted,163.6
1,1/25/2024,,POS WD - VZWRLSS*APOCC VISW     800-922-0204 FLUS,117.26,,Posted,173.94
1,1/25/2024,,POS WD - VENMO  *Kenny Holcomb  Visa Direct  NYUS,964.62,,Posted,291.2
1,1/25/2024,,POS WD - SAVE MART #554 RENO NV 4995 KIETZKE LANE      RENO         N,14.27,,Posted,1255.82
1,1/24/2024,,POS WD - Subway 10118           Reno         NVUS,12.65,,Posted,1270.09
1,1/23/2024,,Point Of Sale Deposit - Amazon Prime           Amzn.com/billWAUS,,12.59,Posted,1282.74
1,1/23/2024,,External WD - NV ENERGY NORTH SPPCO - SPPC PYMT,157.35,,Posted,1270.15
1,1/23/2024,,POS WD - WWW COSTCO COM         800-955-2292 WAUS,99.99,,Posted,1427.5
1,1/22/2024,,External WD - AMERICANEXPRESS PERSONAL SAVINGS - TRANSFER,133.33,,Posted,1527.49
1,1/22/2024,,External WD - DISCOVER DC PYMNTS DCIINTNET - E-PAYMENT,119,,Posted,1660.82
1,1/22/2024,,External WD - FARMERS INS  - EFT PYMT,17.21,,Posted,1779.82
1,1/22/2024,,External DP - VENMO  - CASHOUT,,78.68,Posted,1797.03
1,1/21/2024,,POS WD - PIZZAVA                775-5077077  NVUS,50,,Posted,1718.35
1,1/20/2024,,POS WD - Roku for WarnerMedia Gl816-2728107  DEUS,9.99,,Posted,1768.35
1,1/19/2024,,Deposit - Internet Transfer from XXXXX0643 -  via Mobile,,140,Posted,1778.34
1,1/19/2024,,External DP - ASSIST-2-SELL IN WRS667 02761ASSIS001 - Payroll,,1559.1,Posted,1638.34
1,1/18/2024,,POS WD - OLIVE GARDEN 0021085   RENO         NVUS,23,,Posted,79.24
1,1/18/2024,,POS WD - Amazon Prime*R895C6I70 Amzn.com/billWAUS,14.99,,Posted,102.24
1,1/18/2024,,POS WD - CHEESECAKE RENO        RENO         NVUS,114.72,,Posted,117.23
1,1/17/2024,,POS WD - PETCO  304             RENO         NVUS,27.92,,Posted,231.95
1,1/17/2024,,POS WD - TST* HINOKI POKE       Reno         NVUS,29.5,,Posted,259.87
1,1/17/2024,,External WD - PAYPAL INSTANT TRANSFER - INST XFER,11.99,,Posted,289.37
1,1/17/2024,,External WD - PAYPAL INSTANT TRANSFER - INST XFER,2.99,,Posted,301.36
1,1/17/2024,,POS WD - DENTAL INSURANCE AUTOPA877-2804204  CAUS,31.3,,Posted,304.35
1,1/16/2024,,ATM Fees - ISA - Intl Curr Fee 77000000,0.46,,Posted,335.65
1,1/16/2024,,POS WD - OBSIDIAN.MD            OAKVILLE     ONCA,57.6,,Posted,336.11
1,1/16/2024,,NOW Deposit - Zelle From IHC-Metlife Pet +1-800-421-6674,,257.64,Posted,393.71
1,1/16/2024,,External WD - PAYPAL INSTANT TRANSFER - INST XFER,64,,Posted,136.07
1,1/16/2024,,External WD - PAYPAL INSTANT TRANSFER - INST XFER,6.28,,Posted,200.07
1,1/15/2024,,POS WD - VSP 800-785-0699       800-785-0699 TXUS,13.84,,Posted,206.35
1,1/15/2024,,POS WD - VENMO*                 Visa Direct  NYUS,10,,Posted,220.19
1,1/14/2024,,POS WD - Spotify USA            877-7781161  NYUS,10.99,,Posted,230.19
1,1/11/2024,,POS WD - 7-ELEVEN 6150 S. Mccarran B US  Reno         NVUS,53.37,,Posted,241.18
1,1/11/2024,,NOW Deposit - Zelle From GREGORY PAYNE +1-800-421-6674,,25,Posted,294.55
1,1/11/2024,,POS WD - UBER   EATS            HELP.UBER.COMCAUS,87.63,,Posted,269.55
1,1/10/2024,,POS WD - Walmart.com 702 SW 8th St          Bentonville  ARUS,76.73,,Posted,357.18
1,1/10/2024,,External WD - AMERICANEXPRESS PERSONAL SAVINGS - TRANSFER,233.34,,Posted,433.91
1,1/10/2024,,External WD - HKL 877-292-0545  - PHARMACY,59.95,,Posted,667.25
1,1/9/2024,,POS WD - RAISING CANES 0432     RENO         NVUS,12.97,,Posted,727.2
1,1/9/2024,,Deposit - Internet Transfer from XXXXX0643 -  via Mobile,,627,Posted,740.17
1,1/8/2024,,Withdrawal - Internet Transfer to XXXXX0643 -  via Mobile,627,,Posted,113.17
1,1/8/2024,,External WD - DISCOVER DC PYMNTS DCIINTNET - E-PAYMENT,231,,Posted,740.17
1,1/8/2024,,External WD - ADVS ED SERV WEB ACH TRANSACTION - STUDNTLOAN,150,,Posted,971.17
1,1/8/2024,,External WD - PAYPAL INSTANT TRANSFER - INST XFER,4.99,,Posted,1121.17
1,1/8/2024,,POS WD - UBER   *EATS 1515 3rd Street        San FranciscoCAUS,26.55,,Posted,1126.16
1,1/6/2024,,POS WD - DUTCH BROS             541-955-4700 ORUS,10,,Posted,1152.71
1,1/6/2024,,POS WD - VENMO*                 Visa Direct  NYUS,25,,Posted,1162.71
1,1/6/2024,,POS WD - PORT OF SUBS 0010 ONLINolo.com      NVUS,11.91,,Posted,1187.71
1,1/5/2024,,POS WD - ULTA #1167 4891 KIETZKE LANE      RENO         NVUS,45.98,,Posted,1199.62
1,1/5/2024,,POS WD - 7-ELEVEN 6150 S. Mccarran B US  Reno         NVUS,15.29,,Posted,1245.6
1,1/5/2024,,POS WD - BEST BUY #128 5575 SOUTH VIRGINIA    RENO         NVUS,162.38,,Posted,1260.89
1,1/5/2024,,Withdrawal - Internet Transfer to XXXXX0643 -  via Mobile,140,,Posted,1423.27
1,1/4/2024,,POS WD - METLIFE PET            HTTPSWWW.PETFINUS,44.36,,Posted,1563.27
1,1/4/2024,,External WD - PAYPAL INSTANT TRANSFER - INST XFER,39.99,,Posted,1607.63
1,1/3/2024,,Withdrawal - Shared Branch 6100 NEIL RD STE 150    RENO          NV,5,,Posted,1647.62
1,1/3/2024,,Withdrawal - Shared Branch 6100 NEIL RD STE 150    RENO          NV,59.95,,Posted,1652.62
1,1/3/2024,,External DP - GreaterNevada  - E-DEPOSIT,,25,Posted,1712.57
1,1/3/2024,,Withdrawal - Internet Transfer to XXXXX0643 - barnes and noble,3.34,,Posted,1687.57
1,1/3/2024,,Withdrawal - Internet Transfer to XXXXX0643 - ynab,9.9,,Posted,1690.91
1,1/3/2024,,Withdrawal - Internet Transfer to XXXXX0643 - godaddy,1.85,,Posted,1700.81
1,1/3/2024,,Withdrawal - Internet Transfer to XXXXX0643 -  via Mobile,33.41,,Posted,1702.66
1,1/3/2024,,ATM Deposit - GREATER NEVADA CU 6745 SIERRA CENTER PARKRENO         NVUS,,1554.85,Posted,1736.07
1,1/2/2024,,"External DP - FISHER,MAYA PERSONAL SAVINGS - TRANSFER",,100,Posted,181.22
1,1/2/2024,,Deposit - Internet Transfer from XXXXX0643 -  via Mobile,,33.41,Posted,81.22
1,1/2/2024,,External WD - GEICO  - PREM COLL,96,,Posted,47.81
1,12/31/2023,,Descriptive Deposit - Cash Back Reward,,10,Posted,143.81
1,12/31/2023,,POS WD - STEAMGAMES.COM 42595229425-8899642  WAUS,7.99,,Posted,133.81
1,12/29/2023,,POS WD - GREAT BASIN BREWING COMRENO         NVUS,108.91,,Posted,141.8
1,12/29/2023,,POS WD - Wal-Mart Super Center 2189 WAL-SAMS          RENO         NV,19.07,,Posted,250.71
1,12/29/2023,,POS WD - BARNES&amp;NOBLE PAPERSOURC800-843-2665 NYUS,39.99,,Posted,269.78
1,12/28/2023,,NOW Deposit - Zelle From GREGORY PAYNE +1-800-421-6674,,60,Posted,309.77
1,12/28/2023,,POS WD - TikTok Shop            Mountain ViewCAUS,30.56,,Posted,249.77
1,12/28/2023,,POS WD - GREAT BASIN BREWING COMRENO         NVUS,50,,Posted,280.33
1,12/28/2023,,POS WD - AMZN Mktp US*5K0CQ4J33 Amzn.com/billWAUS,10.79,,Posted,330.33
1,12/28/2023,,POS WD - AMZN Mktp US*HA6JW0223 Amzn.com/billWAUS,106.65,,Posted,341.12
1,12/27/2023,,POS WD - WM SUPERCENTER #2189 Wal-Mart Super Center  RENO         NVU,4.4,,Posted,447.77
1,12/27/2023,,POS WD - SAVE MART #554 RENO NV 4995 KIETZKE LANE      RENO         N,9.48,,Posted,452.17
1,12/27/2023,,POS WD - WL *Steam Purchase     425-9522985  WAUS,50,,Posted,461.65
1,12/27/2023,,POS WD - WL *Steam Purchase     425-9522985  WAUS,32.95,,Posted,511.65
1,12/26/2023,,POS WD - AMZN Mktp US*6Z3CW5B93 Amzn.com/billWAUS,14.14,,Posted,544.6
1,12/26/2023,,POS WD - VENMO*                 Visa Direct  NYUS,965.68,,Posted,558.74
1,12/25/2023,,POS WD - STEAMGAMES.COM 42595229425-8899642  WAUS,17.98,,Posted,1524.42
1,12/25/2023,,POS WD - VZWRLSS*APOCC VISW     800-922-0204 FLUS,117.24,,Posted,1542.4
1,12/23/2023,,POS WD - TST* COSTA VIDA- RENO  RENO         NVUS,40.48,,Posted,1659.64
1,12/22/2023,,POS WD - LOWE'S #32 5075 KIETZKE LANE  US  RENO         NVUS,8.64,,Posted,1700.12
1,12/22/2023,,"POS WD - ELLEN B. MCBRIDE, A PRORENO         NVUS",100,,Posted,1708.76
1,12/22/2023,,External WD - NV ENERGY NORTH SPPCO - SPPC PYMT,133.52,,Posted,1808.76
1,12/21/2023,,ATM Deposit - GREATER NEVADA CU 6745 SIERRA CENTER PKWYRENO         NVUS,,100,Posted,1942.28
1,12/21/2023,,External DP - GreaterNevada  - E-DEPOSIT,,50,Posted,1842.28
1,12/21/2023,,POS WD - APPLE.COM/BILL         866-712-7753 CAUS,11.99,,Posted,1792.28
1,12/21/2023,,POS WD - CHEWY.COM              800-672-4399 FLUS,7.4,,Posted,1804.27
1,12/21/2023,,External WD - AMERICANEXPRESS PERSONAL SAVINGS - TRANSFER,133.34,,Posted,1811.67
1,12/20/2023,,POS WD - CHEWY.COM              800-672-4399 FLUS,113.32,,Posted,1945.01
1,12/20/2023,,POS WD - TARGET T-1363 6845 Sierra Center PkwyReno         NVUS,83.69,,Posted,2058.33
1,12/20/2023,,POS WD - TARGET T-1363 6845 Sierra Center PkwyReno         NVUS,11.89,,Posted,2142.02
1,12/20/2023,,POS WD - WL *Steam Purchase     425-9522985  WAUS,9.99,,Posted,2153.91
1,12/20/2023,,POS WD - Roku for WarnerMedia Gl816-2728107  DEUS,9.99,,Posted,2163.9
1,12/20/2023,,External WD - FARMERS INS  - EFT PYMT,17.21,,Posted,2173.89
1,12/20/2023,,External DP - VENMO  - CASHOUT,,66.76,Posted,2191.1
1,12/20/2023,,External DP - ASSIST-2-SELL IN WRS667 02761ASSIS001 - Payroll,,1554.85,Posted,2124.34
1,12/19/2023,,External DP - GreaterNevada  - E-DEPOSIT,,500,Posted,569.49
1,12/19/2023,,IAT Withdrawal - IAT PAYPAL  1031316479812  CREATIVE FABRICA BV,6,,Posted,69.49
1,12/19/2023,,IAT Withdrawal - IAT PAYPAL  1031316325449  DESIGN BUNDLES LTD,5,,Posted,75.49
1,12/18/2023,,POS WD - Amazon Prime*9M37O2Y23 Amzn.com/billWAUS,14.99,,Posted,80.49
1,12/18/2023,,Withdrawal - Internet Transfer to XXXXX0643 -  via Mobile,30,,Posted,95.48
1,12/18/2023,,Deposit - Internet Transfer from XXXXX0643 -  via Mobile,,30,Posted,125.48
1,12/17/2023,,POS WD - APPLE.COM/BILL         866-712-7753 CAUS,2.99,,Posted,95.48
1,12/17/2023,,POS WD - JACK IN THE BOX 7310   RENO         NVUS,24.56,,Posted,98.47
1,12/17/2023,,POS WD - TST* COSTA VIDA- RENO  RENO         NVUS,16.76,,Posted,123.03
1,12/16/2023,,POS WD - SAVE MART #554 RENO NV 4995 KIETZKE LANE      RENO         N,6.99,,Posted,139.79
1,12/16/2023,,POS WD - WINCO FOODS #12 9750 SOReno         NVUS,67.26,,Posted,146.78
1,12/16/2023,,ATM Deposit - GREATER NEVADA CU 6745 SIERRA CENTER PKWYRENO         NVUS,,65,Posted,214.04
1,12/16/2023,,POS WD - TRADER JOE S #08 TRADERRENO         NVUS,16.78,,Posted,149.04
1,12/16/2023,,POS WD - MICHAELS #9490         800-642-4235 TXUS,11.44,,Posted,165.82
1,12/16/2023,,POS WD - Amazon.com*AE6BS5IV3   Amzn.com/billWAUS,72.06,,Posted,177.26
1,12/15/2023,,POS WD - VSP 800-785-0699       800-785-0699 TXUS,13.84,,Posted,249.32
1,12/15/2023,,"POS WD - WORLDPANTRY.COM, INC.  415-4010080  CAUS",114.38,,Posted,263.16
1,12/14/2023,,POS WD - Spotify USA            877-7781161  NYUS,10.99,,Posted,377.54
1,12/14/2023,,POS WD - Subway 10118           177-58297330 NVUS,14.59,,Posted,388.53
1,12/14/2023,,NOW Deposit - Zelle From GREGORY PAYNE +1-800-421-6674,,57.19,Posted,403.12
1,12/14/2023,,POS WD - RAISING CANES 0432     RENO         NVUS,12.97,,Posted,345.93
1,12/14/2023,,POS WD - GALAXY THEATRE LEGENDS SPARKS       NVUS,27.5,,Posted,358.9
1,12/14/2023,,External WD - DISCOVER DC PYMNTS DCIINTNET - E-PAYMENT,223.29,,Posted,386.4
1,12/12/2023,,POS WD - COSTCO GAS #0025       RENO         NVUS,46.38,,Posted,609.69
1,12/12/2023,,POS WD - APPLE.COM/BILL         866-712-7753 CAUS,4.99,,Posted,656.07
1,12/11/2023,,POS WD - STARBUCKS 800-782-7282 800-782-7282 WAUS,10,,Posted,661.06
1,12/11/2023,,POS WD - STARBUCKS 800-782-7282 800-782-7282 WAUS,15,,Posted,671.06
1,12/11/2023,,POS WD - TST* HAPPY TIERS CAFE  Incline VillaNVUS,5.35,,Posted,686.06
1,12/10/2023,,POS WD - SQ *?HIGH SIERRA GARDENIncline VillaNVUS,31.4,,Posted,691.41
1,12/10/2023,,POS WD - 7-ELEVEN 6150 S. Mccarran B US  Reno         NVUS,6.07,,Posted,722.81
1,12/10/2023,,POS WD - IN-N-OUT RENO 2        RENO         NVUS,16.73,,Posted,728.88
1,12/10/2023,,POS WD - VENMO*                 Visa Direct  NYUS,44.92,,Posted,745.61
1,12/10/2023,,POS WD - TAHOE FAMILY SOLUTIONS 797 SOUTHWOOD BLVD STE1INCLINE VILLAN,7,,Posted,790.53
1,12/8/2023,,POS WD - DOLLARTREE 3800 KIETZKE LN STE 100RENO         NVUS,17.59,,Posted,797.53
1,12/8/2023,,POS WD - SAVERS - 1 3800-250 SOUTH KIETUS  RENO         NVUS,9.19,,Posted,815.12
1,12/7/2023,,POS WD - WWW COSTCO COM         800-955-2292 WAUS,60,,Posted,824.31
1,12/7/2023,,POS WD - TARGET T-1363 6845 Sierra Center PkwyReno         NVUS,3.61,,Posted,884.31
1,12/7/2023,,Point Of Sale Deposit - VENMO*Fisher Maya      New York CityNYUS,,29.48,Posted,887.92
1,12/6/2023,,POS WD - CHEWY.COM              800-672-4399 FLUS,30.83,,Posted,858.44
1,12/6/2023,,POS WD - VENMO*                 Visa Direct  NYUS,25,,Posted,889.27
1,12/6/2023,,POS WD - IN-N-OUT RENO          RENO         NVUS,8.39,,Posted,914.27
1,12/6/2023,,POS WD - Amazon.com*6R1ZO8GK3   Amzn.com/billWAUS,11.95,,Posted,922.66
1,12/6/2023,,POS WD - AMZN Mktp US*9H4JC6KG3 Amzn.com/billWAUS,15.63,,Posted,934.61
1,12/6/2023,,External WD - DISCOVER DC PYMNTS DCIINTNET - E-PAYMENT,209.35,,Posted,950.24
1,12/6/2023,,External WD - AMERICANEXPRESS PERSONAL SAVINGS - TRANSFER,133.33,,Posted,1159.59
1,12/6/2023,,External WD - FID BKG SVC LLC  - MONEYLINE,10,,Posted,1292.92
1,12/6/2023,,POS WD - AMZN Mktp US*U07LJ6373 Amzn.com/billWAUS,12.44,,Posted,1302.92
1,12/6/2023,,POS WD - DENTAL INSURANCE AUTOPA877-2804204  CAUS,31.3,,Posted,1315.36
1,12/6/2023,,POS WD - EQT* AETNA CVS HEALTH  844-3657373  CTUS,87.43,,Posted,1346.66
1,12/5/2023,,POS WD - Wal-Mart Super Center 2189 WAL-SAMS          RENO         NV,71.71,,Posted,1434.09
1,12/5/2023,,Withdrawal - Internet Transfer to XXXXX0643 -  via Mobile,9.9,,Posted,1505.8
1,12/5/2023,,Withdrawal - Internet Transfer to XXXXX0643 -  via Mobile,1.85,,Posted,1515.7
1,12/5/2023,,POS WD - ANTHEM BLUE INDIVIDUAL 844-507-8474 INUS,41.93,,Posted,1517.55
1,12/5/2023,,External DP - ASSIST-2-SELL IN WRS667 02761ASSIS001 - Payroll,,1554.86,Posted,1559.48
1,12/4/2023,,External WD - GEICO  - PREM COLL,96,,Posted,4.62
1,12/4/2023,,POS WD - METLIFE PET            HTTPSWWW.PETFINUS,35.66,,Posted,100.62
1,12/1/2023,,POS WD - SP REMI                HTTPSREMICLUBCAUS,63.87,,Posted,136.28
1,11/30/2023,,Descriptive Deposit - Cash Back Reward,,10,Posted,200.15
1,11/28/2023,,POS WD - TARGET T-1363 6845 Sierra Center PkwyReno         NVUS,7.37,,Posted,190.15
1,11/28/2023,,POS WD - STEAMGAMES.COM 42595229425-8899642  WAUS,27.52,,Posted,197.52
1,11/28/2023,,External DP - VENMO  - CASHOUT,,6,Posted,225.04
1,11/27/2023,,POS WD - Etsy.com - PlantVers   844-6593879  NYUS,4.05,,Posted,219.04
1,11/27/2023,,POS WD - VENMO*                 Visa Direct  NYUS,965.86,,Posted,223.09
1,11/25/2023,,POS WD - VZWRLSS*APOCC VISW     800-922-0204 FLUS,117.01,,Posted,1188.95
1,11/24/2023,,POS WD - SAVERS - 1 3800-250 SOUTH KIETUS  RENO         NVUS,21.07,,Posted,1305.96
1,11/24/2023,,POS WD - TARGET T-1363 6845 Sierra Center PkwyReno         NVUS,5.19,,Posted,1327.03
1,11/24/2023,,External WD - NV ENERGY NORTH SPPCO - SPPC PYMT,106.32,,Posted,1332.22
1,11/24/2023,,POS WD - ROUND1 AM - RNO NV RENORENO         NVUS,11,,Posted,1438.54
1,11/21/2023,,External WD - AMERICANEXPRESS PERSONAL SAVINGS - TRANSFER,133.33,,Posted,1449.54
1,11/21/2023,,External DP - VENMO  - CASHOUT,,53.16,Posted,1582.87
1,11/21/2023,,POS WD - APPLE.COM/BILL         866-712-7753 CAUS,21.98,,Posted,1529.71
1,11/20/2023,,POS WD - Roku for WarnerMedia Gl816-2728107  DEUS,9.99,,Posted,1551.69
1,11/20/2023,,External WD - FARMERS INS  - EFT PYMT,17.21,,Posted,1561.68
1,11/20/2023,,External DP - ASSIST-2-SELL IN WRS667 02761ASSIS001 - Payroll,,1554.84,Posted,1578.89
1,11/20/2023,,POS WD - MICHAELS #9490         800-642-4235 TXUS,41.87,,Posted,24.05
1,11/19/2023,,Point Of Sale Deposit - AMZN Mktp US           Amzn.com/billWAUS,,10.82,Posted,65.92
1,11/19/2023,,POS WD - TST* THE URBAN DELI    Reno         NVUS,38.71,,Posted,55.1
1,11/18/2023,,POS WD - Amazon Prime*MA18C95M3 Amzn.com/billWAUS,14.99,,Posted,93.81
1,11/18/2023,,POS WD - DOLLAR TREE 9760 S VIRGINIA ST     RENO         NVUS,3.96,,Posted,108.8
1,11/18/2023,,POS WD - WINCO FOODS #12 9750 SOReno         NVUS,57.56,,Posted,112.76
1,11/18/2023,,POS WD - WHOLEFDS RNO 102 6139 SRENO         NVUS,12.99,,Posted,170.32
1,11/18/2023,,POS WD - MICHAELS S 4871 KIETZKE LN    US  RENO         NVUS,8.29,,Posted,183.31
1,11/18/2023,,POS WD - APPLE.COM/BILL         866-712-7753 CAUS,2.99,,Posted,191.6
1,11/17/2023,,POS WD - SAVE MART #554 RENO NV 4995 KIETZKE LANE      RENO         N,5.97,,Posted,194.59
1,11/16/2023,,"External DP - FISHER,MAYA PERSONAL SAVINGS - TRANSFER",,100,Posted,200.56
1,11/15/2023,,POS WD - VSP 800-785-0699       800-785-0699 TXUS,13.84,,Posted,100.56
1,11/14/2023,,POS WD - SPOTIFY                877-778-1161 NYUS,10.99,,Posted,114.4
1,11/14/2023,,POS WD - COSTCO GAS #0025       RENO         NVUS,51.42,,Posted,125.39
1,11/13/2023,,POS WD - AMZN Mktp US*UH9FX6UZ3 Amzn.com/billWAUS,10.82,,Posted,176.81
1,11/13/2023,,External WD - PAYPAL INSTANT TRANSFER - INST XFER,0.8,,Posted,187.63
1,11/11/2023,,POS WD - APPLE.COM/BILL         866-712-7753 CAUS,4.99,,Posted,188.43
1,11/9/2023,,POS WD - STARBUCKS 800-782-7282 800-782-7282 WAUS,10,,Posted,193.42
1,11/8/2023,,External WD - AMERICANEXPRESS PERSONAL SAVINGS - TRANSFER,100,,Posted,203.42
1,11/7/2023,,POS WD - CAT PERSON             855-918-2287 NYUS,55.56,,Posted,303.42
1,11/7/2023,,External DP - VENMO  - CASHOUT,,20.5,Posted,358.98
1,11/7/2023,,POS WD - CHIPOTLE 2146          RENO         NVUS,21.6,,Posted,338.48
1,11/7/2023,,POS WD - MICHAELS #9490         800-642-4235 TXUS,5.4,,Posted,360.08
1,11/6/2023,,POS WD - SURF THRU RENO 1       RENO         NVUS,20,,Posted,365.48
1,11/6/2023,,Deposit - Internet Transfer from XXXXX0643 -  via Mobile,,35.99,Posted,385.48
1,11/6/2023,,POS WD - DD DOORDASH HINOKIPOK  855-973-1040 CAUS,26.19,,Posted,349.49
1,11/6/2023,,POS WD - VENMO*                 Visa Direct  NYUS,24.98,,Posted,375.68
1,11/6/2023,,External WD - DISCOVER DC PYMNTS DCIINTNET - E-PAYMENT,350,,Posted,400.66
1,11/6/2023,,External WD - ADVS ED SERV WEB ACH TRANSACTION - STUDNTLOAN,150,,Posted,750.66
1,11/6/2023,,External WD - AMERICANEXPRESS PERSONAL SAVINGS - TRANSFER,133.34,,Posted,900.66
1,11/5/2023,,POS WD - ANTHEM BLUE INDIVIDUAL 844-507-8474 INUS,41.93,,Posted,1034
1,11/5/2023,,POS WD - WINCO FOODS #12 9750 SOReno         NVUS,110.61,,Posted,1075.93
1,11/5/2023,,POS WD - AMZN Mktp US*XE1OY5O03 Amzn.com/billWAUS,67.1,,Posted,1186.54
1,11/4/2023,,POS WD - FAMOUS DAVE'S 3186     RENO         NVUS,79.59,,Posted,1253.64
1,11/4/2023,,POS WD - METLIFE PET            HTTPSWWW.PETFINUS,35.66,,Posted,1333.23
1,11/4/2023,,POS WD - GRUBHUBRAISINGCANESCH  GRUBHUB.COM  NYUS,24.93,,Posted,1368.89
1,11/4/2023,,POS WD - EQT*Hometown Health Pla775-9823232  NVUS,169.54,,Posted,1393.82
1,11/3/2023,,POS WD - SAVE MART #554 RENO NV 4995 KIETZKE LANE      RENO         N,4.79,,Posted,1563.36
1,11/3/2023,,POS WD - ROSS STORE #368        RENO         NVUS,25.43,,Posted,1568.15
1,11/3/2023,,External WD - FID BKG SVC LLC  - MONEYLINE,10,,Posted,1593.58
1,11/3/2023,,Withdrawal - Internet Transfer to XXXXX0643 -  via Mobile,1.85,,Posted,1603.58
1,11/3/2023,,Withdrawal - Internet Transfer to XXXXX0643 -  via Mobile,9.9,,Posted,1605.43
1,11/3/2023,,Withdrawal - Internet Transfer to XXXXX0643 -  via Mobile,17.99,,Posted,1615.33
1,11/3/2023,,External DP - ASSIST-2-SELL IN WRS667 02761ASSIS001 - Payroll,,1554.86,Posted,1633.32
1,11/2/2023,,External WD - GEICO  - PREM COLL,96,,Posted,78.46
1,11/1/2023,,POS WD - RESUMEGENIUS.COM       866-215-9048   VI,2.95,,Posted,174.46
1,10/31/2023,,Descriptive Deposit - Cash Back Reward,,10,Posted,177.41
1,10/26/2023,,POS WD - DNH*GODADDY.COM        480-5058855  AZUS,22.17,,Posted,167.41
1,10/26/2023,,POS WD - VENMO*                 Visa Direct  NYUS,196.95,,Posted,189.58
1,10/25/2023,,"External DP - FISHER,MAYA PERSONAL SAVINGS - TRANSFER",,100,Posted,386.53
1,10/25/2023,,POS WD - VZWRLSS*APOCC VISW     800-922-0204 FLUS,117.24,,Posted,286.53
1,10/25/2023,,"External DP - FISHER,MAYA PERSONAL SAVINGS - TRANSFER",,116,Posted,403.77
1,10/24/2023,,ATM Deposit - GREATER NEVADA CU 6745 SIERRA CENTER PARKRENO         NVUS,,37,Posted,287.77
1,10/24/2023,,Withdrawal - Internet Transfer to XXXXX0643 -  via Mobile,27.9,,Posted,250.77
1,10/24/2023,,POS WD - VENMO*                 Visa Direct  NYUS,968.39,,Posted,278.67
1,10/24/2023,,External WD - NV ENERGY NORTH SPPCO - SPPC PYMT,73.63,,Posted,1247.06
1,10/24/2023,,POS WD - VENMO*                 Visa Direct  NYUS,31.15,,Posted,1320.69
1,10/23/2023,,External WD - DISCOVER DC PYMNTS DCIINTNET - E-PAYMENT,200,,Posted,1351.84
1,10/23/2023,,External DP - VENMO  - CASHOUT,,29,Posted,1551.84
1,10/23/2023,,External DP - VENMO  - CASHOUT,,36.82,Posted,1522.84
1,10/22/2023,,POS WD - WALGREENS STORE 750 N VRENO         NVUS,32.76,,Posted,1486.02
1,10/21/2023,,POS WD - VENMO*                 Visa Direct  NYUS,45.17,,Posted,1518.78
1,10/21/2023,,POS WD - AUTOZONE  0533 5000 SMITH RIDGE       RENO         NVUS,64.94,,Posted,1563.95
1,10/21/2023,,ATM Withdrawal - CVS  STORE 5019  S MCCARRAN BLUS  RENO         NVUS,60,,Posted,1628.89
1,10/21/2023,,POS WD - Roku for WarnerMedia Gl816-2728107  DEUS,9.99,,Posted,1688.89
1,10/20/2023,,POS WD - DUTCH BROS NV0602 RENO RENO         NVUS,6.59,,Posted,1698.88
1,10/20/2023,,External WD - FARMERS INS  - EFT PYMT,17.21,,Posted,1705.47
1,10/20/2023,,External DP - ASSIST-2-SELL IN WRS667 02761ASSIS001 - Payroll,,1554.85,Posted,1722.68
1,10/18/2023,,POS WD - Amazon Prime*TP74W4BV1 Amzn.com/billWAUS,14.99,,Posted,167.83
1,10/18/2023,,"External DP - FISHER,MAYA PERSONAL SAVINGS - TRANSFER",,100,Posted,182.82
1,10/17/2023,,External WD - FID BKG SVC LLC  - MONEYLINE,50,,Posted,82.82
1,10/17/2023,,POS WD - APPLE.COM/BILL         866-712-7753 CAUS,11.99,,Posted,132.82
1,10/17/2023,,POS WD - APPLE.COM/BILL         866-712-7753 CAUS,2.99,,Posted,144.81
1,10/15/2023,,POS WD - VENMO*                 Visa Direct  NYUS,26.18,,Posted,147.8
1,10/15/2023,,POS WD - 7-ELEVEN 33090         RENO         NVUS,11.79,,Posted,173.98
1,10/15/2023,,POS WD - VSP 800-785-0699       800-785-0699 TXUS,13.84,,Posted,185.77
1,10/14/2023,,POS WD - GRUBHUBHINOKIPOKE      GRUBHUB.COM  NYUS,24.9,,Posted,199.61
1,10/14/2023,,POS WD - SPOTIFY                877-778-1161 NYUS,10.99,,Posted,224.51
1,10/14/2023,,POS WD - ULTA #1167 4891 KIETZKE LANE      RENO         NVUS,12.97,,Posted,235.5
1,10/14/2023,,POS WD - COSTCO GAS #0025       RENO         NVUS,50.03,,Posted,248.47
1,10/14/2023,,POS WD - WHOLEFDS RNO 102 6139 SRENO         NVUS,10.49,,Posted,298.5
1,10/13/2023,,POS WD - PETCO.COM 6989         858-453-7845 CAUS,31.46,,Posted,308.99
1,10/12/2023,,POS WD - TRACY LEGEE HTTPS://TRACY-LEGEE.CLIRENO         NVUS,100,,Posted,340.45
1,10/11/2023,,POS WD - GRUBHUBCOSTAVIDAFRESH  GRUBHUB.COM  NYUS,34.72,,Posted,440.45
1,10/11/2023,,POS WD - SAVE MART #554 RENO NV 4995 KIETZKE LANE      RENO         N,10.89,,Posted,475.17
1,10/11/2023,,POS WD - APPLE.COM/BILL         866-712-7753 CAUS,4.99,,Posted,486.06
1,10/11/2023,,External WD - AMERICANEXPRESS PERSONAL SAVINGS - TRANSFER,100,,Posted,491.05
1,10/10/2023,,POS WD - Wal-Mart Super Center 2189 WAL-SAMS          RENO (S)     NV,75.5,,Posted,591.05
1,10/10/2023,,External DP - VENMO  - CASHOUT,,219.44,Posted,666.55
1,10/9/2023,,POS WD - SAVE MART #554 RENO NV 4995 KIETZKE LANE      RENO         N,17.24,,Posted,447.11
1,10/9/2023,,POS WD - AMZN Mktp US*T90PR7UD1 Amzn.com/billWAUS,31.68,,Posted,464.35
1,10/7/2023,,POS WD - VENMO*                 Visa Direct  NYUS,49.85,,Posted,496.03
1,10/7/2023,,POS WD - COSTCO WHSE #0025      RENO         NVUS,423.77,,Posted,545.88
1,10/6/2023,,POS WD - COMETEER               COMETEER.COM MAUS,84,,Posted,969.65
1,10/6/2023,,External WD - ADVS ED SERV WEB ACH TRANSACTION - STUDNTLOAN,150,,Posted,1053.65
1,10/6/2023,,External WD - AMERICANEXPRESS PERSONAL SAVINGS - TRANSFER,150,,Posted,1203.65
1,10/6/2023,,External WD - NV ENERGY NORTH SPPCO - SPPC PYMT,7.66,,Posted,1353.65
1,10/6/2023,,POS WD - ANTHEM BLUE INDIVIDUAL 844-507-8474 INUS,41.93,,Posted,1361.31
1,10/6/2023,,POS WD - EQT*Hometown Health Pla775-9823232  NVUS,169.54,,Posted,1403.24
1,10/5/2023,,POS WD - VENMO*                 Visa Direct  NYUS,3,,Posted,1572.78
1,10/5/2023,,External DP - ASSIST-2-SELL IN WRS667 02761ASSIS001 - Payroll,,1554.85,Posted,1575.78
1,10/5/2023,,POS WD - STEAMGAMES.COM 42595229425-8899642  WAUS,14.99,,Posted,20.93
1,10/4/2023,,POS WD - METLIFE PET            HTTPSWWW.PETFINUS,35.66,,Posted,35.92
1,10/3/2023,,POS WD - DOLLARTREE 3800 KIETZKE LN STE 100RENO         NVUS,12.18,,Posted,71.58
1,10/3/2023,,External DP - VENMO  - CASHOUT,,29,Posted,83.76
1,10/2/2023,,External WD - GEICO  - PREM COLL,96,,Posted,54.76
1,9/30/2023,,Descriptive Deposit - Cash Back Reward,,10,Posted,150.76
1,9/27/2023,,"POS WD - ELLEN B. MCBRIDE, A PRORENO         NVUS",100,,Posted,140.76
1,9/27/2023,,"External DP - FISHER,MAYA PERSONAL SAVINGS - TRANSFER",,35.66,Posted,240.76
1,9/26/2023,,POS WD - SAVE MART #554 RENO NV 4995 KIETZKE LANE      RENO         N,11.47,,Posted,205.1
1,9/25/2023,,POS WD - VZWRLSS*APOCC VISW     800-922-0204 FLUS,117.1,,Posted,216.57
1,9/25/2023,,External WD - NV ENERGY NORTH SPPCO - SPPC PYMT,108.59,,Posted,333.67
1,9/25/2023,,External WD - NV ENERGY NORTH SPPCO - SPPC PYMT,24.93,,Posted,442.26
1,9/24/2023,,POS WD - UBER   *EATS 1515 3rd Street        San FranciscoCAUS,33.73,,Posted,467.19
1,9/22/2023,,POS WD - BEST BUY #128 5575 SOUTH VIRGINIA    RENO         NVUS,21.64,,Posted,500.92
1,9/22/2023,,Point Of Sale Deposit - TARGET T-1363 6845 Sierra Center PkwyReno         NVUS,,32.48,Posted,522.56
1,9/22/2023,,"External DP - FISHER,MAYA PERSONAL SAVINGS - TRANSFER",,100,Posted,490.08
1,9/22/2023,,External DP - VENMO  - CASHOUT,,12.46,Posted,390.08
1,9/22/2023,,"External DP - FISHER,MAYA PERSONAL SAVINGS - TRANSFER",,26,Posted,377.62
1,9/22/2023,,External DP - VENMO  - CASHOUT,,27.15,Posted,351.62
1,9/22/2023,,External DP - VENMO  - CASHOUT,,27.15,Posted,324.47
1,9/21/2023,,POS WD - Kindle Svcs*TX01A4MA1  888-802-3080 WAUS,0.99,,Posted,297.32
1,9/21/2023,,POS WD - Roku for WarnerMedia Gl816-2728107  DEUS,9.99,,Posted,298.31
1,9/21/2023,,NOW Deposit - Zelle From TOBIN SCHULTZ +1-800-421-6674,,27.15,Posted,308.3
1,9/21/2023,,POS WD - DOUGHBOYS DONUTS 2 5115 MAE ANNE AVE STE BRENO         NVUS,14.08,,Posted,281.15
1,9/21/2023,,External WD - DISCOVER DC PYMNTS DCIINTNET - E-PAYMENT,350,,Posted,295.23
1,9/21/2023,,External WD - AMERICANEXPRESS PERSONAL SAVINGS - TRANSFER,150,,Posted,645.23
1,9/21/2023,,External WD - ADVS ED SERV WEB ACH TRANSACTION - STUDNTLOAN,150,,Posted,795.23
1,9/20/2023,,POS WD - COSTCO GAS #0025       RENO         NVUS,57.22,,Posted,945.23
1,9/20/2023,,POS WD - TikTok Shop Seller     Mountain ViewCAUS,28.14,,Posted,1002.45
1,9/20/2023,,POS WD - VENMO*                 Visa Direct  NYUS,954.5,,Posted,1030.59
1,9/20/2023,,Deposit - Internet Transfer from XXXXX0643 -  via Mobile,,970,Posted,1985.09
1,9/20/2023,,Withdrawal - Internet Transfer to XXXXX0643 -  via Mobile,970,,Posted,1015.09
1,9/20/2023,,External WD - FARMERS INS  - EFT PYMT,17.21,,Posted,1985.09
1,9/20/2023,,External DP - VENMO  - CASHOUT,,7,Posted,2002.3
1,9/20/2023,,External DP - ASSIST-2-SELL IN WRS667 02761ASSIS001 - Payroll,,1554.85,Posted,1995.3
1,9/19/2023,,External DP - VENMO  - CASHOUT,,30,Posted,440.45
1,9/19/2023,,POS WD - APPLE CASH SENT MONEY  1INFINITELOOPCAUS,4,,Posted,410.45
1,9/18/2023,,POS WD - DD DOORDASH INDIAKEBA  855-973-1040 CAUS,24.88,,Posted,414.45
1,9/17/2023,,POS WD - VENMO*                 Visa Direct  NYUS,25,,Posted,439.33
1,9/17/2023,,POS WD - LOWE'S #32 5075 KIETZKE LANE  US  RENO         NVUS,4.85,,Posted,464.33
1,9/17/2023,,POS WD - STARBUCKS STORE 09767  RENO         NVUS,18.57,,Posted,469.18
1,9/17/2023,,POS WD - DD DOORDASH PIZZAVA    855-973-1040 CAUS,44.54,,Posted,487.75
1,9/17/2023,,POS WD - SAVE MART #554 RENO NV 4995 KIETZKE LANE      RENO         N,13.42,,Posted,532.29
1,9/17/2023,,POS WD - TARGET T-1363 6845 Sierra Center PkwyReno         NVUS,46.2,,Posted,545.71
1,9/17/2023,,POS WD - TARGET T-1363 6845 Sierra Center PkwyReno         NVUS,10.18,,Posted,591.91
1,9/17/2023,,POS WD - APPLE.COM/BILL         866-712-7753 CAUS,2.99,,Posted,602.09
1,9/17/2023,,POS WD - APPLE.COM/BILL         866-712-7753 CAUS,11.99,,Posted,605.08
1,9/16/2023,,POS WD - TST* Hinoki Poke       Reno         NVUS,38.97,,Posted,617.07
1,9/16/2023,,POS WD - TACOS JALISCO CANTINA  RENO         NVUS,76.78,,Posted,656.04
1,9/16/2023,,POS WD - Wal-Mart Super Center 4239 WAL-SAMS          RENO         NV,10.67,,Posted,732.82
1,9/15/2023,,"External DP - FISHER,MAYA PERSONAL SAVINGS - TRANSFER",,600,Posted,743.49
1,9/15/2023,,External WD - DISCOVER DC PYMNTS DCIINTNET - E-PAYMENT,100,,Posted,143.49
1,9/15/2023,,POS WD - VSP 800-785-0699       800-785-0699 TXUS,13.84,,Posted,243.49
1,9/15/2023,,POS WD - WENDY'S 1000 N HILLS BLVD      RENO         NVUS,15.27,,Posted,257.33
1,9/14/2023,,POS WD - SPOTIFY                877-778-1161 NYUS,10.99,,Posted,272.6
1,9/14/2023,,POS WD - DUTCH BROS             541-955-4700 ORUS,10,,Posted,283.59
1,9/14/2023,,POS WD - VENMO*                 Visa Direct  NYUS,61.14,,Posted,293.59
1,9/14/2023,,"External DP - FISHER,MAYA PERSONAL SAVINGS - TRANSFER",,281.38,Posted,354.73
1,9/12/2023,,POS WD - DUTCH BROS NV0601 RENO RENO         NVUS,6.25,,Posted,73.35
1,9/11/2023,,POS WD - APPLE.COM/BILL         866-712-7753 CAUS,4.99,,Posted,79.6
1,9/10/2023,,POS WD - QDOBA 2368             RENO         NVUS,12.88,,Posted,84.59
1,9/9/2023,,POS WD - STARBUCKS STORE 09767  RENO         NVUS,4.54,,Posted,97.47
1,9/9/2023,,POS WD - SMITHS FOOD # 4344 175 LEMMON DRIVE       RENO         NVUS,15.47,,Posted,102.01
1,9/9/2023,,POS WD - SMITHS FOOD # 43 175 LERENO         NVUS,5.68,,Posted,117.48
1,9/8/2023,,POS WD - PHO 777                RENO         NVUS,16.73,,Posted,123.16
1,9/8/2023,,POS WD - STARBUCKS 800-782-7282 800-782-7282 WAUS,10,,Posted,139.89
1,9/8/2023,,External WD - AMERICANEXPRESS PERSONAL SAVINGS - TRANSFER,950,,Posted,149.89
1,9/8/2023,,External WD - AMERICANEXPRESS PERSONAL SAVINGS - TRANSFER,100,,Posted,1099.89
1,9/7/2023,,POS WD - WM SUPERCENTER #4239 Wal-Mart Super Center  RENO         NVU,65.98,,Posted,1199.89
1,9/7/2023,,NOW Withdrawal - Zelle To GREGORY PAYNE +1-800-421-6674,10,,Posted,1265.87
1,9/7/2023,,Deposit - Internet Transfer from XXXXX0643 -  via Mobile,,950,Posted,1275.87
1,9/7/2023,,External WD - DISCOVER DC PYMNTS DCIINTNET - E-PAYMENT,73.04,,Posted,325.87
1,9/6/2023,,POS WD - TRADER JOE S #08 TRADERRENO         NVUS,29.56,,Posted,398.91
1,9/6/2023,,POS WD - FIVE BELOW 1399 6137 S VIRGINIA ST     RENO         NVUS,10.83,,Posted,428.47
1,9/6/2023,,External WD - AMERICANEXPRESS PERSONAL SAVINGS - TRANSFER,100,,Posted,439.3
1,9/6/2023,,POS WD - EQT*Hometown Health Pla775-9823232  NVUS,169.54,,Posted,539.3
1,9/6/2023,,POS WD - ANTHEM BLUE INDIVIDUAL 844-507-8474 INUS,41.93,,Posted,708.84
1,9/5/2023,,Withdrawal - Internet Transfer to XXXXX0643 -  via Mobile,950,,Posted,750.77
1,9/5/2023,,POS WD - SMITHS-FUEL #9344 175 LEMMON DR          RENO         NVUS,25.57,,Posted,1700.77
1,9/5/2023,,External WD - GEICO  - PREM COLL,95.96,,Posted,1726.34
1,9/5/2023,,External DP - ASSIST-2-SELL IN WRS667 02761ASSIS001 - Payroll,,1639.89,Posted,1822.3
1,9/4/2023,,POS WD - VENMO*                 Visa Direct  NYUS,12.64,,Posted,182.41
1,9/4/2023,,POS WD - CAT PERSON             855-918-2287 NYUS,111.06,,Posted,195.05
1,9/4/2023,,POS WD - DD DOORDASH GOLDENFLO  855-973-1040 CAUS,23,,Posted,306.11
1,9/4/2023,,POS WD - DD DOORDASH BASKIN-RO  855-973-1040 CAUS,16.55,,Posted,329.11
1,9/4/2023,,ATM Deposit - GREATER NEVADA CU 5150 MAE ANNE AVE      RENO         NVUS,,267,Posted,345.66
1,9/4/2023,,Max Overdraft Access Fee (SYS) - METLIFE PET            HTTPSWWW.PETFINUS,35,,Posted,78.66
1,9/4/2023,,POS WD - METLIFE PET            HTTPSWWW.PETFINUS,35.66,,Posted,113.66
1,9/3/2023,,POS WD - STARBUCKS 800-782-7282 800-782-7282 WAUS,10,,Posted,149.32
1,9/3/2023,,POS WD - TACO BELL 031862       RENO         NVUS,8.21,,Posted,159.32
1,9/3/2023,,POS WD - CLOUD9 VAPE &amp; SMOKE SH 440 E GOLDEN VALLEY RD#RENO         N,24.2,,Posted,167.53
1,9/3/2023,,POS WD - MAVERIK #443           RENO         NVUS,4.5,,Posted,191.73
1,9/3/2023,,NOW Withdrawal - Zelle To GREGORY PAYNE +1-800-421-6674,46,,Posted,196.23
1,9/2/2023,,POS WD - DD DOORDASH EGGROLLKI  855-973-1040 CAUS,35.02,,Posted,242.23
1,9/2/2023,,Point Of Sale Deposit - VENMO*Fisher Maya      New York CityNYUS,,29.48,Posted,277.25
1,9/2/2023,,POS WD - VENMO*                 Visa Direct  NYUS,250,,Posted,247.77
1,9/2/2023,,POS WD - SMITHS FOOD # 4344 175 LEMMON DRIVE       RENO         NVUS,10.47,,Posted,497.77
1,9/2/2023,,POS WD - DUTCH BROS             541-955-4700 ORUS,25,,Posted,508.24
1,9/1/2023,,NOW Deposit - Zelle From GREGORY PAYNE +1-800-421-6674,,35,Posted,533.24
1,9/1/2023,,POS WD - STARBUCKS 800-782-7282 800-782-7282 WAUS,15,,Posted,498.24
1,9/1/2023,,Deposit - Internet Transfer from XXXXX0643 -  via Mobile,,20.12,Posted,513.24
1,9/1/2023,,POS WD - SQ *BACK FORTY TEXAS BBPLEASANT HILLCAUS,35.65,,Posted,493.12
1,8/31/2023,,Descriptive Deposit - Cash Back Reward,,10,Posted,528.77
1,8/31/2023,,POS WD - 7-ELEVEN 250 PYRAMID WAY    US  SPARKS       NVUS,4,,Posted,518.77
1,8/31/2023,,Deposit - Internet Transfer from XXXXX0643 -  via Mobile,,458.02,Posted,522.77
1,8/30/2023,,POS WD - AMZN Mktp US*T32AW7BN1 Amzn.com/billWAUS,54.12,,Posted,64.75
1,8/30/2023,,POS WD - AMZN Mktp US*T31UW3I10 Amzn.com/billWAUS,31.89,,Posted,118.87
1,8/30/2023,,POS WD - SAVE MART #554 RENO NV 4995 KIETZKE LANE      RENO         N,7.57,,Posted,150.76
1,8/28/2023,,NOW Withdrawal - Zelle To MORGAN CARTLEDGE +1-800-421-6674,471.9,,Posted,158.33
1,8/28/2023,,Deposit - Internet Transfer from XXXXX0643 -  via Mobile,,471.9,Posted,630.23
1,8/27/2023,,POS WD - WETZEL'S PRETZELS #K104RENO         NVUS,6.05,,Posted,158.33
1,8/27/2023,,POS WD - SMITHS FOOD # 4344     RENO         NVUS,3.02,,Posted,164.38
1,8/26/2023,,POS WD - DRIVETHRU 2211 North First StreetSan Jose     CAUS,4.32,,Posted,167.4
1,8/26/2023,,POS WD - 7-ELEVEN 6150 S. MCCARRAN   US  RENO         NVUS,10.82,,Posted,171.72
1,8/26/2023,,POS WD - COSTCO GAS #0025       RENO         NVUS,47.31,,Posted,182.54
1,8/26/2023,,POS WD - ULTA.COM               866-858-2266 ILUS,21.21,,Posted,229.85
1,8/26/2023,,POS WD - ROSS STORES #855       RENO         NVUS,51.38,,Posted,251.06
1,8/25/2023,,POS WD - VZWRLSS*APOCC VISW     800-922-0204 FLUS,117.01,,Posted,302.44
1,8/25/2023,,POS WD - AMZN Mktp US*TQ9FE3UN1 Amzn.com/billWAUS,53.5,,Posted,419.45
1,8/24/2023,,External WD - NV ENERGY NORTH SPPCO - SPPC PYMT,119.25,,Posted,472.95
1,8/24/2023,,External DP - VENMO  - CASHOUT,,29.81,Posted,592.2
1,8/24/2023,,External DP - VENMO  - CASHOUT,,42.47,Posted,562.39
1,8/24/2023,,POS WD - JERSEY MIKES 17016     RENO         NVUS,2.59,,Posted,519.92
1,8/23/2023,,POS WD - DUTCH BROS NV0601 RENO RENO         NVUS,3.66,,Posted,522.51
1,8/23/2023,,POS WD - SAVE MART #554 RENO NV 4995 KIETZKE LANE      RENO         N,26.96,,Posted,526.17
1,8/22/2023,,POS WD - FIVE BELOW 1399 6137 S VIRGINIA ST     RENO         NVUS,18.68,,Posted,553.13
1,8/22/2023,,POS WD - PETCO 304              RENO         NVUS,43.6,,Posted,571.81
1,8/22/2023,,NOW Deposit - Zelle From TOBIN SCHULTZ +1-800-421-6674,,29.81,Posted,615.41
1,8/22/2023,,POS WD - AMZN Mktp US*TQ8N64XA1 Amzn.com/billWAUS,81.19,,Posted,585.6
1,8/22/2023,,POS WD - EQT*Hometown Health Pla775-9823232  NVUS,169.54,,Posted,666.79
1,8/21/2023,,POS WD - VENMO*                 Visa Direct  NYUS,12.81,,Posted,836.33
1,8/21/2023,,NOW Deposit - Zelle From GREGORY PAYNE +1-800-421-6674,,30,Posted,849.14
1,8/21/2023,,POS WD - Roku for WarnerMedia Gl816-2728107  DEUS,9.99,,Posted,819.14
1,8/21/2023,,External WD - DISCOVER DC PYMNTS DCIINTNET - E-PAYMENT,171.16,,Posted,829.13
1,8/21/2023,,External WD - FARMERS INS  - EFT PYMT,17.21,,Posted,1000.29
1,8/20/2023,,POS WD - DD DOORDASH GOLDENFLO  855-973-1040 CAUS,21.31,,Posted,1017.5
1,8/20/2023,,Withdrawal - Internet Transfer to XXXXX0643 -  via Mobile,475,,Posted,1038.81
1,8/20/2023,,POS WD - DOORDASH DASHPASS      WWW.DOORDASH.CAUS,4.99,,Posted,1513.81
1,8/19/2023,,POS WD - SQ *WALDENS COFFEE HOUSRENO         NVUS,42.22,,Posted,1518.8
1,8/19/2023,,POS WD - TST* Hinoki Poke       Reno         NVUS,20.95,,Posted,1561.02
1,8/18/2023,,POS WD - SAVE MART #554 RENO NV 4995 KIETZKE LANE      RENO         N,6.49,,Posted,1581.97
1,8/18/2023,,POS WD - DUTCH BROS             541-955-4700 ORUS,10,,Posted,1588.46
1,8/18/2023,,External DP - ASSIST-2-SELL IN WRS667 02761ASSIS001 - Payroll,,1471.15,Posted,1598.46
1,8/17/2023,,POS WD - MCDONALD'S F5023 5000 S VIRGINIA        RENO         NVUS,6.58,,Posted,127.31
1,8/17/2023,,POS WD - APPLE.COM/BILL         866-712-7753 CAUS,9.99,,Posted,133.89
1,8/17/2023,,POS WD - APPLE.COM/BILL         866-712-7753 CAUS,2.99,,Posted,143.88
1,8/17/2023,,NOW Withdrawal - Zelle To TOBIN SCHULTZ +1-800-421-6674,23.02,,Posted,146.87
1,8/15/2023,,POS WD - Netflix.com            866-5797172  CAUS,15.49,,Posted,169.89
1,8/15/2023,,POS WD - VSP 800-785-0699       800-785-0699 TXUS,13.84,,Posted,185.38
1,8/14/2023,,POS WD - SPOTIFY                877-778-1161 NYUS,9.99,,Posted,199.22
1,8/14/2023,,POS WD - DUTCH BROS             541-955-4700 ORUS,10,,Posted,209.21
1,8/14/2023,,POS WD - SAVE MART #554 RENO NV 4995 KIETZKE LANE      RENO         N,18.26,,Posted,219.21
1,8/13/2023,,POS WD - COSTCO GAS #0025       RENO         NVUS,46.35,,Posted,237.47
1,8/13/2023,,POS WD - MAVERIK #443           RENO         NVUS,4.32,,Posted,283.82
1,8/13/2023,,POS WD - SMITHS FOOD # 4344 175 LEMMON DRIVE       RENO         NVUS,29.6,,Posted,288.14
1,8/12/2023,,POS WD - SUSHI ROSE             RENO         NVUS,89.59,,Posted,317.74
1,8/12/2023,,POS WD - APPLE.COM/BILL         866-712-7753 CAUS,4.99,,Posted,407.33
1,8/11/2023,,POS WD - Instacart 50 Beal St Suite 600   San FranciscoCAUS,34.96,,Posted,412.32
1,8/10/2023,,Point Of Sale Deposit - TikTok Shop Seller     Mountain ViewCAUS,,44.3,Posted,447.28
1,8/10/2023,,POS WD - PORT OF SUBS 0010      RENO         NVUS,18.73,,Posted,402.98
1,8/9/2023,,POS WD - TRACY LEGEE            HTTPSTRACYLEGNVUS,100,,Posted,421.71
1,8/9/2023,,POS WD - TikTok Shop Seller     Mountain ViewCAUS,44.3,,Posted,521.71
1,8/8/2023,,External WD - AMERICANEXPRESS PERSONAL SAVINGS - TRANSFER,100,,Posted,566.01
1,8/8/2023,,POS WD - SAVE MART #554 RENO NV 4995 KIETZKE LANE      RENO         N,2.29,,Posted,666.01
1,8/8/2023,,POS WD - ANTHEM BLUE INDIVIDUAL 844-507-8474 INUS,41.93,,Posted,668.3
1,8/7/2023,,Withdrawal - Internet Transfer to XXXXX0643 - Get Ahead on Rent,475,,Posted,710.23
1,8/7/2023,,External WD - DISCOVER DC PYMNTS DCIINTNET - E-PAYMENT,171.16,,Posted,1185.23
1,8/7/2023,,External DP - VENMO  - CASHOUT,,22.4,Posted,1356.39
1,8/7/2023,,External DP - VENMO  - CASHOUT,,125,Posted,1333.99
1,8/6/2023,,POS WD - 7-ELEVEN 8075 LEMMON DR     US  RENO         NVUS,11.88,,Posted,1208.99
1,8/6/2023,,POS WD - JACK IN THE BOX 7316   RENO         NVUS,11.15,,Posted,1220.87
1,8/6/2023,,POS WD - WINCO FOODS #17 2855 N Reno         NVUS,75.94,,Posted,1232.02
1,8/5/2023,,POS WD - SMITHS FOOD # 4344 175 LEMMON DRIVE       RENO         NVUS,27.27,,Posted,1307.96
1,8/5/2023,,NOW Withdrawal - Zelle To GREGORY PAYNE +1-800-421-6674,40,,Posted,1335.23
1,8/4/2023,,POS WD - COSTCO GAS #0025       RENO         NVUS,53.05,,Posted,1375.23
1,8/4/2023,,POS WD - 7-ELEVEN 6150 S. MCCARRAN   US  RENO         NVUS,3.75,,Posted,1428.28
1,8/4/2023,,External DP - ASSIST-2-SELL IN WRS667 02761ASSIS001 - Payroll,,1471.14,Posted,1432.03
1,8/4/2023,,Max OD Access Fee (SYS) - METLIFE PET            HTTPSWWW.PETFINUS,35,,Posted,-39.11
1,8/4/2023,,POS WD - METLIFE PET            HTTPSWWW.PETFINUS,35.66,,Posted,-4.11
1,8/3/2023,,POS WD - DD DOORDASH LOSCUATRO  855-973-1040 CAUS,13.71,,Posted,31.55
1,8/2/2023,,POS WD - SMITHS FOOD # 4344 175 LEMMON DRIVE       RENO         NVUS,4.8,,Posted,45.26
1,8/2/2023,,POS WD - TST* COSTA VIDA- RENO  RENO         NVUS,20.67,,Posted,50.06
1,8/2/2023,,External WD - GEICO  - PREM COLL,112.86,,Posted,70.73
1,8/2/2023,,"External DP - FISHER,MAYA PERSONAL SAVINGS - TRANSFER",,50,Posted,183.59
1,7/31/2023,,Descriptive Deposit - Cash Back Reward,,10,Posted,133.59
1,7/31/2023,,POS WD - SAVE MART #554 RENO NV 4995 KIETZKE LANE      RENO         N,4.49,,Posted,123.59
1,7/30/2023,,POS WD - SMITHS FOOD # 4344 175 LEMMON DRIVE       RENO         NVUS,48.1,,Posted,128.08
1,7/30/2023,,POS WD - SMITHS-FUEL #9344 175 LEMMON DR          RENO         NVUS,22.23,,Posted,176.18
1,7/29/2023,,NOW Deposit - Zelle From GREGORY PAYNE +1-800-421-6674,,25.5,Posted,198.41
1,7/29/2023,,POS WD - ROSS STORES #855       RENO         NVUS,30.68,,Posted,172.91
1,7/29/2023,,POS WD - ROSS STORES #855       RENO         NVUS,62.74,,Posted,203.59
1,7/29/2023,,POS WD - WEST WIND DRIVE-INS    415-448-8500 CAUS,19,,Posted,266.33
1,7/29/2023,,POS WD - CVS/PHARMACY #08792 8792--680 N. Mc CarrenSparks       NVUS,14.21,,Posted,285.33
1,7/29/2023,,POS WD - LITTLE CAESARS 1410 0001 656 N MCCARRAN BLVD    SPARKS,16.55,,Posted,299.54
1,7/28/2023,,NOW Deposit - Zelle From GREGORY PAYNE +1-800-421-6674,,65,Posted,316.09
1,7/28/2023,,POS WD - SAVE MART #554 RENO NV 4995 KIETZKE LANE      RENO         N,8.34,,Posted,251.09
1,7/28/2023,,External DP - VENMO  - CASHOUT,,9.69,Posted,259.43
1,7/28/2023,,"External DP - FISHER,MAYA PERSONAL SAVINGS - TRANSFER",,150,Posted,249.74
1,7/27/2023,,POS WD - VENMO*                 Visa Direct  NYUS,33.74,,Posted,99.74
1,7/27/2023,,POS WD - VENMO*                 Visa Direct  NYUS,33.74,,Posted,133.48
1,7/27/2023,,NOW Withdrawal - Zelle To TOBIN SCHULTZ +1-800-421-6674,29.07,,Posted,167.22
1,7/27/2023,,POS WD - SAVE MART #554 RENO NV 4995 KIETZKE LANE      RENO         N,2,,Posted,196.29
1,7/27/2023,,POS WD - RAISING CANES 0432     RENO         NVUS,17.2,,Posted,198.29
1,7/27/2023,,POS WD - PP*DUTCH BROS NV0601   GRANTS PASS  ORUS,6.23,,Posted,215.49
1,7/25/2023,,POS WD - VZWRLSS*APOCC VISW     800-922-0204 FLUS,117.01,,Posted,221.72
1,7/25/2023,,External WD - NV ENERGY NORTH SPPCO - SPPC PYMT,266.93,,Posted,338.73
1,7/24/2023,,"External DP - FISHER,MAYA PERSONAL SAVINGS - TRANSFER",,120,Posted,605.66
1,7/24/2023,,POS WD - SAVE MART #554 RENO NV 4995 KIETZKE LANE      RENO         N,47.72,,Posted,485.66
1,7/24/2023,,External DP - VENMO  - CASHOUT,,66.73,Posted,533.38
1,7/23/2023,,POS WD - SMITHS FOOD # 43 175 LERENO         NVUS,14.69,,Posted,466.65
1,7/22/2023,,NOW Deposit - Zelle From MORGAN CARTLEDGE +1-800-421-6674,,66.73,Posted,481.34
1,7/22/2023,,NOW Deposit - Zelle From TOBIN SCHULTZ +1-800-421-6674,,66.73,Posted,414.61
1,7/22/2023,,POS WD - VENMO*                 Visa Direct  NYUS,106.07,,Posted,347.88
1,7/22/2023,,POS WD - SMITHS FOOD # 4344 175 LEMMON DRIVE       RENO         NVUS,44,,Posted,453.95
1,7/22/2023,,POS WD - SMITHS FOOD # 4344 175 LEMMON DRIVE       RENO         NVUS,3.02,,Posted,497.95
1,7/22/2023,,POS WD - BASKIN #361216 Q35     RENO         NVUS,14,,Posted,500.97
1,7/22/2023,,POS WD - EQT*Hometown Health Pla775-9823232  NVUS,169.54,,Posted,514.97
1,7/22/2023,,POS WD - MCDONALD'S F11402 5148 MAE ANNE BLVD     RENO         NVUS,7.67,,Posted,684.51
1,7/21/2023,,POS WD - NEKTERJUICEBAR         HTTPSLOCATIONNVUS,12.26,,Posted,692.18
1,7/21/2023,,POS WD - Roku for WarnerMedia Gl816-2728107  DEUS,9.99,,Posted,704.44
1,7/21/2023,,External WD - DISCOVER DC PYMNTS DCIINTNET - E-PAYMENT,119.08,,Posted,714.43
1,7/20/2023,,POS WD - AMZN Mktp US*KD5933XQ3 Amzn.com/billWAUS,23.81,,Posted,833.51
1,7/20/2023,,POS WD - AMZN Mktp US*FE95Q3VQ3 Amzn.com/billWAUS,8,,Posted,857.32
1,7/20/2023,,POS WD - VENMO*                 Visa Direct  NYUS,577.8,,Posted,865.32
1,7/20/2023,,POS WD - VENMO*                 Visa Direct  NYUS,22.52,,Posted,1443.12
1,7/20/2023,,External WD - FARMERS INS  - EFT PYMT,17.24,,Posted,1465.64
1,7/20/2023,,External DP - ASSIST-2-SELL IN WRS667 02761ASSIS001 - Payroll,,1471.16,Posted,1482.88
1,7/18/2023,,POS WD - Subway 10118           Reno         NVUS,36.69,,Posted,11.72
1,7/18/2023,,POS WD - SMITHS FOOD # 4344 175 LEMMON DRIVE       RENO         NVUS,28.8,,Posted,48.41
1,7/18/2023,,POS WD - COSTCO GAS #0025       RENO         NVUS,48.44,,Posted,77.21
1,7/17/2023,,POS WD - MCDONALD'S F5023 5000 S VIRGINIA        RENO         NVUS,4.74,,Posted,125.65
1,7/17/2023,,POS WD - APPLE.COM/BILL         866-712-7753 CAUS,2.99,,Posted,130.39
1,7/17/2023,,POS WD - APPLE.COM/BILL         866-712-7753 CAUS,9.99,,Posted,133.38
1,7/16/2023,,POS WD - BASKIN #347880 Q35     SPARKS       NVUS,7.39,,Posted,143.37
1,7/16/2023,,POS WD - DUNKIN #353932 Q35     SPARKS       NVUS,26,,Posted,150.76
1,7/15/2023,,POS WD - VSP 800-785-0699       800-785-0699 TXUS,13.84,,Posted,176.76
1,7/15/2023,,POS WD - MCDONALD'S F11402 5148 MAE ANNE BLVD     RENO         NVUS,1.4,,Posted,190.6
1,7/15/2023,,POS WD - Netflix                1 8445052993 CAUS,15.49,,Posted,192
1,7/15/2023,,POS WD - EGG ROLL KING 1        RENO         NVUS,5.37,,Posted,207.49
1,7/15/2023,,POS WD - SPOTIFY                877-778-1161 NYUS,9.99,,Posted,212.86
1,7/14/2023,,POS WD - MCDONALD'S F1064 440 KEYSTONE AVE       RENO         NVUS,3.44,,Posted,222.85
1,7/13/2023,,ATM Deposit - GREATER NEVADA CU 120 SALOMON COURT      SPARKS       NVUS,,200,Posted,226.29
1,7/13/2023,,POS WD - DUTCH BROS             541-955-4700 ORUS,10,,Posted,26.29
1,7/13/2023,,POS WD - APPLE.COM/BILL         866-712-7753 CAUS,4.99,,Posted,36.29
1,7/12/2023,,POS WD - AMZN Mktp US*4D27X5XZ3 Amzn.com/billWAUS,177.1,,Posted,41.28
1,7/12/2023,,POS WD - AMZN Mktp US*PW8DX9CH3 Amzn.com/billWAUS,6.47,,Posted,218.38
1,7/12/2023,,"External DP - FISHER,MAYA PERSONAL SAVINGS - TRANSFER",,20,Posted,224.85
1,7/12/2023,,POS WD - TRACY LEGEE            HTTPSTRACYLEGNVUS,100,,Posted,204.85
1,7/12/2023,,POS WD - TRACY LEGEE            HTTPSTRACYLEGNVUS,100,,Posted,304.85
1,7/12/2023,,POS WD - AMZN Mktp US*GE7EW3GF3 Amzn.com/billWAUS,28.15,,Posted,404.85
1,7/12/2023,,"External DP - FISHER,MAYA PERSONAL SAVINGS - TRANSFER",,200,Posted,433
1,7/12/2023,,POS WD - AMZN Mktp US*6B3324FB3 Amzn.com/billWAUS,128.48,,Posted,233
1,7/11/2023,,POS WD - AMZN Mktp US*XH4MS9CP3 Amzn.com/billWAUS,33.12,,Posted,361.48
1,7/11/2023,,POS WD - PT *RENOWN HEALTH      RENO         NVUS,50,,Posted,394.6
1,7/10/2023,,NOW Withdrawal - Zelle To TOBIN SCHULTZ +1-800-421-6674,24.25,,Posted,444.6
1,7/10/2023,,POS WD - Amazon Prime*8U9NO9YB3 Amzn.com/billWAUS,0.99,,Posted,468.85
1,7/10/2023,,POS WD - VENMO*                 Visa Direct  NYUS,15,,Posted,469.84
1,7/10/2023,,POS WD - CAT PERSON             855-918-2287 NYUS,111.06,,Posted,484.84
1,7/10/2023,,External WD - AMERICANEXPRESS PERSONAL SAVINGS - TRANSFER,300,,Posted,595.9
1,7/10/2023,,External WD - AMERICANEXPRESS PERSONAL SAVINGS - TRANSFER,100,,Posted,895.9
1,7/10/2023,,POS WD - RICKS PIZZA - RENO     RENO         NVUS,19.76,,Posted,995.9
1,7/9/2023,,NOW Deposit - Zelle From GREGORY PAYNE +1-800-421-6674,,13,Posted,1015.66
1,7/9/2023,,POS WD - QDOBA 2305             RENO         NVUS,34.1,,Posted,1002.66
1,7/8/2023,,POS WD - SMITHS FOOD # 4344 175 LEMMON DRIVE       RENO         NVUS,22.05,,Posted,1036.76
1,7/8/2023,,POS WD - SMITHS-FUEL #9344 175 LEMMON DR          RENO         NVUS,53.73,,Posted,1058.81
1,7/8/2023,,POS WD - SQ *WILLIAM'S COFFE    PHOENIX      AZUS,31.51,,Posted,1112.54
1,7/7/2023,,POS WD - FRYS FUEL # 7096 26300 N NORTERRA PK    PHOENIX      AZUS,32.34,,Posted,1144.05
1,7/7/2023,,POS WD - VENMO*                 Visa Direct  NYUS,36.6,,Posted,1176.39
1,7/7/2023,,POS WD - TST* JAMBA JUICE - 1426PHOENIX      AZUS,19.66,,Posted,1212.99
1,7/7/2023,,POS WD - YOUNEEDABUDGET.COM     HTTPSWWW.YOUNUTUS,98.99,,Posted,1232.65
1,7/6/2023,,POS WD - ONE STOP NUTRITION     PHOENIX      AZUS,61.88,,Posted,1331.64
1,7/6/2023,,POS WD - TJMAXX #0668 3409 W. THUNDERBIRD RD.PHOENIX THUNDAZUS,4.33,,Posted,1393.52
1,7/6/2023,,External WD - DISCOVER DC PYMNTS DCIINTNET - E-PAYMENT,38.99,,Posted,1397.85
1,7/6/2023,,POS WD - ANTHEM BLUE INDIVIDUAL 844-507-8474 INUS,41.93,,Posted,1436.84
1,7/5/2023,,POS WD - ASH AVE COMICS         TEMPE        AZUS,6.49,,Posted,1478.77
1,7/5/2023,,POS WD - TARGET T-1141 2727 W Agua Fria Fwy   Phoenix      AZUS,70.57,,Posted,1485.26
1,7/5/2023,,External WD - AMERICANEXPRESS PERSONAL SAVINGS - TRANSFER,100,,Posted,1555.83
1,7/5/2023,,External DP - ASSIST-2-SELL IN WRS667 02761ASSIS001 - Payroll,,1471.15,Posted,1655.83
1,7/4/2023,,POS WD - METLIFE PET            HTTPSWWW.PETFINUS,35.66,,Posted,184.68
1,7/4/2023,,POS WD - VENMO*                 Visa Direct  NYUS,28,,Posted,220.34
1,7/3/2023,,"External DP - FISHER,MAYA PERSONAL SAVINGS - TRANSFER",,100,Posted,248.34
1,7/3/2023,,External WD - GEICO  - PREM COLL,112.88,,Posted,148.34
1,7/3/2023,,External DP - VENMO  - CASHOUT,,176,Posted,261.22
1,7/2/2023,,POS WD - COCA COLA TEMPE AZ     TEMPE        AZUS,5.7,,Posted,85.22
1,7/2/2023,,POS WD - STEAMGAMES.COM 42595229425-8899642  WAUS,2.99,,Posted,90.92
1,7/2/2023,,POS WD - VENMO*                 Visa Direct  NYUS,81.82,,Posted,93.91
1,7/1/2023,,POS WD - ODYSEA AQUARIUM 9500 E SCOTTSDALE   AZUS,63.75,,Posted,175.73
1,7/1/2023,,POS WD - AKCHIN PAVILION AMPHI  PHOENIX      AZUS,10.86,,Posted,239.48
1,7/1/2023,,POS WD - VENMO*                 Visa Direct  NYUS,178.2,,Posted,250.34
1,7/1/2023,,POS WD - TALKING STICK RESORT A 165-02396947 CAUS,130.32,,Posted,428.54
1,6/30/2023,,Descriptive Deposit - Cash Back Reward,,10,Posted,558.86
1,6/30/2023,,POS WD - VENMO*                 Visa Direct  NYUS,60.02,,Posted,548.86
1,6/29/2023,,POS WD - PP*DUTCH BROS NV0601   GRANTS PASS  ORUS,8.85,,Posted,608.88
1,6/27/2023,,POS WD - SAVE MART #554 RENO NV 4995 KIETZKE LANE      RENO         N,14.77,,Posted,617.73
1,6/27/2023,,POS WD - SMITHS FOOD # 4344     RENO         NVUS,3.02,,Posted,632.5
1,6/26/2023,,POS WD - AMZN Mktp US*CH09B55D3 Amzn.com/billWAUS,4.92,,Posted,635.52
1,6/25/2023,,POS WD - AMZN Mktp US*UP4DV0DS3 Amzn.com/billWAUS,34.63,,Posted,640.44
1,6/25/2023,,POS WD - VZWRLSS*APOCC VISW     800-922-0204 FLUS,126.93,,Posted,675.07
1,6/24/2023,,POS WD - SMITHS FOOD # 4344 175 LEMMON DRIVE       RENO         NVUS,15.54,,Posted,802
1,6/23/2023,,POS WD - WM SUPERCENTER #3254 Wal-Mart Super Center  RENO         NVU,21.39,,Posted,817.54
1,6/22/2023,,POS WD - 7-ELEVEN 6150 S. MCCARRAN   US  RENO         NVUS,6.74,,Posted,838.93
1,6/22/2023,,"POS WD - ELLEN B. MCBRIDE, A PRORENO         NVUS",100,,Posted,845.67
1,6/22/2023,,NOW Deposit - Zelle From IHC-Metlife Pet +1-800-421-6674,,95.51,Posted,945.67
1,6/22/2023,,External WD - NV ENERGY NORTH SPPCO - SPPC PYMT,101.2,,Posted,850.16
1,6/22/2023,,POS WD - PP*DUTCH BROS NV0601   GRANTS PASS  ORUS,18.68,,Posted,951.36
1,6/21/2023,,POS WD - VENMO*                 Visa Direct  NYUS,574.92,,Posted,970.04
1,6/21/2023,,POS WD - APPLE.COM/BILL         866-712-7753 CAUS,9.99,,Posted,1544.96
1,6/21/2023,,External WD - DISCOVER DC PYMNTS DCIINTNET - E-PAYMENT,92.47,,Posted,1554.95
1,6/21/2023,,External DP - VENMO  - CASHOUT,,67.47,Posted,1647.42
1,6/21/2023,,"External DP - FISHER,MAYA PERSONAL SAVINGS - TRANSFER",,200,Posted,1579.95
1,6/21/2023,,"POS WD - Roku 2711 Centerville Road, Wilmington   DEUS",9.99,,Posted,1379.95
1,6/20/2023,,POS WD - VENMO*                 Visa Direct  NYUS,116.18,,Posted,1389.94
1,6/20/2023,,POS WD - VENMO*                 Visa Direct  NYUS,28.76,,Posted,1506.12
1,6/20/2023,,External WD - FARMERS INS  - EFT PYMT,17.21,,Posted,1534.88
1,6/20/2023,,External DP - ASSIST-2-SELL IN WRS667 02761ASSIS001 - Payroll,,1471.14,Posted,1552.09
1,6/18/2023,,POS WD - 7-ELEVEN 8075 LEMMON DR     US  RENO         NVUS,6.53,,Posted,80.95
1,6/17/2023,,POS WD - STEAMGAMES.COM 42595229425-8899642  WAUS,15.5,,Posted,87.48
1,6/17/2023,,POS WD - APPLE.COM/BILL         866-712-7753 CAUS,2.99,,Posted,102.98
1,6/17/2023,,POS WD - COSTCO GAS #0025       RENO         NVUS,30.07,,Posted,105.97
1,6/17/2023,,POS WD - PP*DUTCH BROS NV0601   GRANTS PASS  ORUS,8.85,,Posted,136.04
1,6/16/2023,,POS WD - TRADER JOE S #08 TRADERRENO         NVUS,37.77,,Posted,144.89
1,6/15/2023,,POS WD - Netflix.com            866-5797172  CAUS,15.49,,Posted,182.66
1,6/15/2023,,POS WD - VSP 800-785-0699       800-785-0699 TXUS,13.84,,Posted,198.15
1,6/15/2023,,POS WD - SPOTIFY                877-778-1161 NYUS,9.99,,Posted,211.99
1,6/13/2023,,POS WD  VENMO*                 Visa Direct  NYUS,25,,Posted,221.98
1,6/13/2023,,POS WD  VENMO*                 Visa Direct  NYUS,20.54,,Posted,246.98
1,6/12/2023,,External WD PAYPAL 230611PPZ2XV - INST XFER,14.99,,Posted,267.52
1,6/11/2023,,POS WD  APPLE.COM/BILL         866-712-7753 CAUS,4.99,,Posted,282.51
1,6/11/2023,,POS WD  CENTURY THEATRES 443   RENO         NVUS,21.54,,Posted,287.5
1,6/11/2023,,POS WD  BLUEFIN POKE           RENO         NVUS,47.74,,Posted,309.04
1,6/9/2023,,NOW Withdrawal  Zelle To GREGORY PAYNE +1-800-421-6674,88,,Posted,356.78
1,6/9/2023,,"External DP FISHER,MAYA PERSONAL SAVINGS - TRANSFER",,100,Posted,444.78
1,6/8/2023,,External WD AMERICANEXPRESS PERSONAL SAVINGS - TRANSFER,300,,Posted,344.78
1,6/8/2023,,External WD DISCOVER DC PYMNTS DCIINTNET - E-PAYMENT,200,,Posted,644.78
1,6/8/2023,,External WD AMERICANEXPRESS PERSONAL SAVINGS - TRANSFER,100,,Posted,844.78
1,6/7/2023,,POS WD  IN N OUT BURGER 377    RENO         NVUS,8.39,,Posted,944.78
1,6/7/2023,,POS WD  COSTCO GAS #0025       RENO         NVUS,48.39,,Posted,953.17
1,6/7/2023,,POS WD  TRACY LEGEE            HTTPSTRACYLEGNVUS,100,,Posted,1001.56
1,6/6/2023,,POS WD VCA ANIMAL 4792 CAUGHLIN PKWY US  RENO         NVUS,119.39,,Posted,1101.56
1,6/6/2023,,POS WD  EQT*Hometown Health Pla775-9823232  NVUS,169.54,,Posted,1220.95
1,6/6/2023,,POS WD  ANTHEM BLUE INDIVIDUAL 844-507-8474 INUS,41.93,,Posted,1390.49
1,6/5/2023,,External DP ASSIST-2-SELL IN WRS667 02761ASSIS001 - Payroll,,1471.16,Posted,1432.42
1,6/4/2023,,POS WD  WILD ISLAND -ADMISSIONSSPARKS       NVUS,24.5,,Posted,-38.74
1,6/4/2023,,Max OD Access Fee (SYS)  METLIFE PET            HTTPSWWW.PETFINUS,35,,Posted,-14.24
1,6/4/2023,,Overdraft Protection Deposit,,1.09,Posted,20.76
1,6/4/2023,,POS WD  METLIFE PET            HTTPSWWW.PETFINUS,35.66,,Posted,19.67
1,6/3/2023,,"POS WD  SQ *WILD ISLAND, INC.  Sparks       NVUS",17.82,,Posted,55.33
1,6/3/2023,,"POS WD  SQ *WILD ISLAND, INC.  Sparks       NVUS",19,,Posted,73.15
1,6/3/2023,,POS WD  PP*DUTCH BROS NV0601   GRANTS PASS  ORUS,7.4,,Posted,92.15
1,6/2/2023,,POS WD WM SUPERCENTER #3254 Wal-Mart Super Center  RENO         NVU,17.94,,Posted,99.55
1,6/2/2023,,"External DP FISHER,MAYA PERSONAL SAVINGS - TRANSFER",,50,Posted,117.49
1,6/2/2023,,External WD GEICO  - PREM COLL,112.88,,Posted,67.49
1,6/1/2023,,POS WD  VENMO*                 Visa Direct  NYUS,16.36,,Posted,180.37
1,6/1/2023,,POS WD  VENMO*                 Visa Direct  NYUS,28.76,,Posted,196.73
1,5/31/2023,,Descriptive Deposit Cash Back Reward,,10,Posted,225.49
1,5/30/2023,,POS WD  QDOBA 2368             RENO         NVUS,16.44,,Posted,215.49
1,5/29/2023,,POS WD  Amazon.com*UY5133HI3   Amzn.com/billWAUS,12.74,,Posted,231.93
1,5/28/2023,,POS WD  DD DOORDASH GOLDENFLO  855-973-1040 CAUS,37.53,,Posted,244.67
1,5/28/2023,,POS WD  DD DOORDASH GOLDENFLO  855-973-1040 CAUS,41.02,,Posted,282.2
1,5/28/2023,,POS WD  SQ *NATURAL SELECTION SReno         NVUS,19.49,,Posted,323.22
1,5/27/2023,,POS WD  AMZN Mktp US*9A2BJ2873 Amzn.com/billWAUS,27.76,,Posted,342.71
1,5/27/2023,,POS WD  AMZN Mktp US*RH1GE5GP3 Amzn.com/billWAUS,28.11,,Posted,370.47
1,5/27/2023,,POS WD SMITHS FOOD # 4344 175 LEMMON DRIVE       RENO         NVUS,7.96,,Posted,398.58
1,5/27/2023,,POS WD  TST* JAMBA JUICE - 0498RENO         NVUS,9.07,,Posted,406.54
1,5/26/2023,,POS WD WAL-MART #3254 5260 W 7TH ST          RENO         NVUS,5.93,,Posted,415.61
1,5/26/2023,,POS WD SAVE MART #554 RENO NV 4995 KIETZKE LANE      RENO         N,15.15,,Posted,421.54
1,5/26/2023,,Point Of Sale Deposit  AMZN Mktp US           Amzn.com/billWAUS,,33.93,Posted,436.69
1,5/25/2023,,POS WD  NEKTERJUICEBAR         HTTPSLOCATIONNVUS,13,,Posted,402.76
1,5/25/2023,,POS WD  VZWRLSS*APOCC VISW     800-922-0204 FLUS,106.42,,Posted,415.76
1,5/24/2023,,POS WD  AMZN Mktp US*G323Z1XA3 Amzn.com/billWAUS,10.82,,Posted,522.18
1,5/23/2023,,POS WD  APPLE.COM/BILL         866-712-7753 CAUS,2.99,,Posted,533
1,5/23/2023,,"External DP FISHER,MAYA PERSONAL SAVINGS - TRANSFER",,150,Posted,535.99
1,5/23/2023,,POS WD  AMZN Mktp US*EV5GA8AA3 Amzn.com/billWAUS,23.81,,Posted,385.99
1,5/23/2023,,POS WD  AMZN Mktp US*OO6T11QJ3 Amzn.com/billWAUS,91.25,,Posted,409.8
1,5/23/2023,,POS WD  TRADER JOE S #08 TRADERRENO         NVUS,31.92,,Posted,501.05
1,5/23/2023,,Deposit Internet Transfer from xxx0643,,160,Posted,532.97
1,5/23/2023,,Withdrawal Internet Transfer to xxx0643,80,,Posted,372.97
1,5/23/2023,,POS WD  VENMO*                 Visa Direct  NYUS,760.56,,Posted,452.97
1,5/23/2023,,Deposit Internet Transfer from xxx0643,,760,Posted,1213.53
1,5/23/2023,,External DP VENMO  - CASHOUT,,67.48,Posted,453.53
1,5/23/2023,,POS WD  TST* The Urban Deli    Reno         NVUS,19.37,,Posted,386.05
1,5/22/2023,,POS WD LEMMON WAY GROCERY OUTLE 200 LEMMON DRIVE.      RENO,1.95,,Posted,405.42
1,5/22/2023,,External WD AMERICANEXPRESS PERSONAL SAVINGS - TRANSFER,34,,Posted,407.37
1,5/22/2023,,External WD FARMERS INS  - EFT PYMT,17.21,,Posted,441.37
1,5/21/2023,,POS WD  SQ *OLIVIER'S ORGANIC FReno         NVUS,31.18,,Posted,458.58
1,5/21/2023,,POS WD  SQ *MWINTSOPH ENTERPRISReno         NVUS,22.66,,Posted,489.76
1,5/21/2023,,POS WD  SQ *LITTLE FISH COMPANYAuburn       CAUS,38.79,,Posted,512.42
1,5/21/2023,,POS WD VIOC IG0001 305 BUCK DR            RENO         NVUS,82.02,,Posted,551.21
1,5/21/2023,,"POS WD Roku 2711 Centerville Road, Wilmington   DEUS",9.99,,Posted,633.23
1,5/20/2023,,POS WD  CHEVRON/FAST LANE      TRUCKEE      CAUS,13.12,,Posted,643.22
1,5/19/2023,,POS WD SMITHS FOOD # 4344 175 LEMMON DRIVE       RENO         NVUS,11.72,,Posted,656.34
1,5/19/2023,,POS WD  DUTCH BROS             541-955-4700 ORUS,15,,Posted,668.06
1,5/19/2023,,Withdrawal rent,760,,Posted,683.06
1,5/19/2023,,Withdrawal Internet Transfer to xxx0643,80,,Posted,1443.06
1,5/19/2023,,External DP ASSIST-2-SELL IN WRS667 02761ASSIS001 - Payroll,,1471.15,Posted,1523.06
1,5/18/2023,,POS WD  AMZN Mktp US*2779W40W3 Amzn.com/billWAUS,33.93,,Posted,51.91
1,5/18/2023,,POS WD  DUTCH BROS             541-955-4700 ORUS,15,,Posted,85.84
1,5/17/2023,,POS WD SAVE MART #554 RENO NV 4995 KIETZKE LANE      RENO         N,10.48,,Posted,100.84
1,5/17/2023,,POS WD  APPLE.COM/BILL         866-712-7753 CAUS,2.99,,Posted,111.32
1,5/16/2023,,External WD AMERICANEXPRESS PERSONAL SAVINGS - TRANSFER,50,,Posted,114.31
1,5/16/2023,,External WD AMERICANEXPRESS PERSONAL SAVINGS - TRANSFER,10,,Posted,164.31
1,5/15/2023,,Deposit Internet Transfer from xxx0643,,80,Posted,174.31
1,5/15/2023,,POS WD  Steam Purchase         425-9522985  WAUS,2.99,,Posted,94.31
1,5/15/2023,,POS WD SAVE MART #554 RENO NV 4995 KIETZKE LANE      RENO         N,14.97,,Posted,97.3
1,5/15/2023,,External WD AMERICANEXPRESS PERSONAL SAVINGS - TRANSFER,24,,Posted,112.27
1,5/15/2023,,POS WD  NETFLIX COM            LOS GATOS    CAUS,15.49,,Posted,136.27
1,5/15/2023,,POS WD  VSP 800-785-0699       800-785-0699 TXUS,13.84,,Posted,151.76
1,5/14/2023,,POS WD  SPOTIFY                877-778-1161 NYUS,9.99,,Posted,165.6
1,5/14/2023,,POS WD  SP SUGAR LOVE CANDY    180-04799830 NVUS,7,,Posted,175.59
1,5/14/2023,,POS WD  SQ *RIN TIN TAPS       Reno         NVUS,14.4,,Posted,182.59
1,5/14/2023,,POS WD  SQ *PREMA FARM         Reno         NVUS,11,,Posted,196.99
1,5/14/2023,,POS WD  SQ *UVAL CARE          Reno         NVUS,16.24,,Posted,207.99
1,5/14/2023,,POS WD  VENMO*                 Visa Direct  NYUS,50.05,,Posted,224.23
1,5/14/2023,,"POS WD Uber Technologies, Inc 405 Howard St          San FranciscoC",5.23,,Posted,274.28
1,5/13/2023,,"POS WD Uber Technologies, Inc 405 Howard St          San FranciscoC",30.8,,Posted,279.51
1,5/13/2023,,POS WD  VENMO*                 Visa Direct  NYUS,105.35,,Posted,310.31
1,5/13/2023,,POS WD SMITHS FOOD # 4344 175 LEMMON DRIVE       RENO         NVUS,6.7,,Posted,415.66
1,5/13/2023,,POS WD  CHEWY.COM              800-672-4399 FLUS,56.15,,Posted,422.36
1,5/12/2023,,External WD AMERICANEXPRESS PERSONAL SAVINGS - TRANSFER,14,,Posted,478.51
1,5/12/2023,,POS WD  APPLE.COM/BILL         800-275-2273 CAUS,4.99,,Posted,492.51
1,5/11/2023,,POS WD  NEKTER JUICE BAR 8195  RENO         NVUS,11.77,,Posted,497.5
1,5/11/2023,,POS WD  DD DOORDASH INDIAKEBA  855-973-1040 CAUS,29.54,,Posted,509.27
1,5/11/2023,,External WD PAYPAL INSTANT TRANSFER - INST XFER,14.99,,Posted,538.81
1,5/11/2023,,External WD AMERICANEXPRESS PERSONAL SAVINGS - TRANSFER,10,,Posted,553.8
1,5/10/2023,,Deposit Internet Transfer from xxx0643,,189.32,Posted,563.8
1,5/9/2023,,External WD AMERICANEXPRESS PERSONAL SAVINGS - TRANSFER,100,,Posted,374.48
1,5/8/2023,,POS WD  VENMO*                 Visa Direct  NYUS,61,,Posted,474.48
1,5/8/2023,,External WD DISCOVER DC PYMNTS DCIINTNET - E-PAYMENT,307.94,,Posted,535.48
1,5/7/2023,,Deposit dental insurance,,41.93,Posted,843.42
1,5/7/2023,,Withdrawal Internet Transfer to xxx0643,50,,Posted,801.49
1,5/6/2023,,POS WD  BATH AND BODY WORKS 523SPARKS       NVUS,107.51,,Posted,851.49
1,5/6/2023,,POS WD  VENMO*                 Visa Direct  NYUS,82.68,,Posted,959
1,5/6/2023,,POS WD  ANTHEM BLUE INDIVIDUAL 844-507-8474 INUS,41.93,,Posted,1041.68
1,5/5/2023,,POS WD  SLUSHEES VAPOR         RENO         NVUS,16.23,,Posted,1083.61
1,5/5/2023,,POS WD SAVE MART #554 RENO NV 4995 KIETZKE LANE      RENO         N,6.93,,Posted,1099.84
1,5/5/2023,,POS WD  DUTCH BROS             541-955-4700 ORUS,15,,Posted,1106.77
1,5/5/2023,,Withdrawal upcoming bills,231.25,,Posted,1121.77
1,5/5/2023,,POS WD  VENMO*                 Visa Direct  NYUS,37.5,,Posted,1353.02
1,5/5/2023,,POS WD  VENMO*                 Visa Direct  NYUS,83.05,,Posted,1390.52
1,5/5/2023,,External DP ASSIST-2-SELL IN WRS667 02761ASSIS001 - Payroll,,1471.15,Posted,1473.57
1,5/4/2023,,POS WD  RAISING CANES 0432     RENO         NVUS,11.9,,Posted,2.42
1,5/4/2023,,POS WD  METLIFE PET            HTTPSWWW.PETFINUS,35.66,,Posted,14.32
1,5/3/2023,,POS WD  TST* COSTA VIDA- RENO  RENO         NVUS,16.75,,Posted,49.98
1,5/3/2023,,POS WD MCDONALD'S F5023 5000 S VIRGINIA        RENO         NVUS,9.3,,Posted,66.73
1,5/3/2023,,POS WD  COSTCO GAS #0025       RENO         NVUS,48.1,,Posted,76.03
1,5/2/2023,,External WD GEICO  - PREM COLL,112.88,,Posted,124.13
1,5/1/2023,,External WD NV ENERGY NORTH SPPCO - SPPC PYMT,108.43,,Posted,237.01
1,5/1/2023,,External WD PAYPAL INSTANT TRANSFER - INST XFER,38.92,,Posted,345.44
1,5/1/2023,,External DP VENMO  - CASHOUT,,15.77,Posted,384.36
1,5/1/2023,,NOW Deposit  Zelle From IHC-Metlife Pet +1-800-421-6674,,68.5,Posted,368.59
1,4/30/2023,,Descriptive Deposit Cash Back Reward,,10,Posted,300.09
1,4/30/2023,,POS WD 7-ELEVEN 8075 LEMMON DR     US  RENO         NVUS,11.08,,Posted,290.09
1,4/30/2023,,POS WD  APPLE.COM/BILL         866-712-7753 CAUS,3.99,,Posted,301.17
1,4/27/2023,,POS WD  CHATGPT SUBSCRIPTION   OPENAI.COM   CAUS,20,,Posted,305.16
1,4/27/2023,,Deposit Internet Transfer from xxx0643,,100,Posted,325.16
1,4/26/2023,,POS WD SAVE MART #554 RENO NV 4995 KIETZKE LANE      RENO         N,26.43,,Posted,225.16
1,4/25/2023,,POS WD  PHO RESTAURANT         RENO         NVUS,55.64,,Posted,251.59
1,4/25/2023,,POS WD  WINCO FOODS #17 2855 N Reno         NVUS,81.68,,Posted,307.23
1,4/25/2023,,POS WD  VZWRLSS*APOCC VISW     800-922-0204 FLUS,106.42,,Posted,388.91
1,4/25/2023,,External DP VENMO  - CASHOUT,,36.14,Posted,495.33
1,4/25/2023,,External DP VENMO  - CASHOUT,,36.15,Posted,459.19
1,4/25/2023,,POS WD  DNDBEYOND.CODDB CONTE  DNDBEYOND.COMWAUS,29.99,,Posted,423.04
1,4/24/2023,,POS WD  VENMO*                 Visa Direct  NYUS,29.9,,Posted,453.03
1,4/24/2023,,POS WD  CAT PERSON             855-918-2287 NYUS,111.06,,Posted,482.93
1,4/24/2023,,NOW Deposit  Zelle From MARIA APARICIO +1-800-421-6674,,70,Posted,593.99
1,4/24/2023,,External DP VENMO  - CASHOUT,,175.38,Posted,523.99
1,4/24/2023,,POS WD  PRESS START LLC        RENO         NVUS,15.52,,Posted,348.61
1,4/23/2023,,POS WD  SQ *BIBO COFFEE CO. / BReno         NVUS,10.74,,Posted,364.13
1,4/22/2023,,ATM Foreign Trns Fee (SYS),3,,Posted,374.87
1,4/22/2023,,POS WD  MICHAELS DELI          RENO         NVUS,32.11,,Posted,377.87
1,4/22/2023,,ATM Withdrawal PRESS START 1413 S VIRGINIA ST     Reno         NVUS,42.5,,Posted,409.98
1,4/22/2023,,POS WD  GALAXY THEATRE LEGENDS SPARKS       NVUS,32.75,,Posted,452.48
1,4/21/2023,,POS WD  SMITHS 5344            775-971-3310 NVUS,21.18,,Posted,485.23
1,4/21/2023,,POS WD  Roku for WarnerMedia Gl816-2728107  DEUS,9.99,,Posted,506.41
1,4/21/2023,,POS WD  VENMO*                 Visa Direct  NYUS,759.74,,Posted,516.4
1,4/21/2023,,Deposit Internet Transfer from xxx0643,,760,Posted,1276.14
1,4/21/2023,,External WD DISCOVER DC PYMNTS DCIINTNET - E-PAYMENT,120,,Posted,516.14
1,4/20/2023,,POS WD  COSTCO GAS #0025       RENO         NVUS,46.74,,Posted,636.14
1,4/20/2023,,POS WD  COSTCO WHSE #0025      RENO         NVUS,35.47,,Posted,682.88
1,4/20/2023,,Withdrawal rent,760,,Posted,718.35
1,4/20/2023,,External WD FARMERS INS  - EFT PYMT,17.21,,Posted,1478.35
1,4/20/2023,,External DP ASSIST-2-SELL IN WRS667 02761ASSIS001 - Payroll,,1471.15,Posted,1495.56
1,4/19/2023,,POS WD SAVE MART #554 RENO NV 4995 KIETZKE LANE      RENO         N,4,,Posted,24.41
1,4/19/2023,,POS WD  DUTCH BROS             541-955-4700 ORUS,10,,Posted,28.41
1,4/18/2023,,POS WD SMITHS FOOD # 4344 175 LEMMON DRIVE       RENO         NVUS,10.39,,Posted,38.41
1,4/18/2023,,POS WD SMITHS FOOD # 4344 175 LEMMON DRIVE       RENO         NVUS,4.66,,Posted,48.8
1,4/18/2023,,POS WD SMITHS FOOD # 4344 175 LEMMON DRIVE       RENO         NVUS,2.15,,Posted,53.46
1,4/17/2023,,POS WD  ROMANOS 1184           RENO         NVUS,45.32,,Posted,55.61
1,4/16/2023,,POS WD APPLE COM ONE APPLE PARK WAY US  CUPERTINO    CAUS,2.99,,Posted,100.93
1,4/15/2023,,POS WD  VSP 800-785-0699       800-785-0699 TXUS,13.84,,Posted,103.92
1,4/15/2023,,POS WD  BARNESNOBLE 5555 S. VirReno         NVUS,20.57,,Posted,117.76
1,4/15/2023,,POS WD  NETFLIX COM            LOS GATOS    CAUS,15.49,,Posted,138.33
1,4/15/2023,,POS WD  SPOTIFY                877-778-1161 NYUS,9.99,,Posted,153.82
1,4/14/2023,,POS WD SMITHS FOOD # 4344 175 LEMMON DRIVE       RENO         NVUS,23.78,,Posted,163.81
1,4/13/2023,,POS WD SAVE MART #554 RENO NV 4995 KIETZKE LANE      RENO         N,21.44,,Posted,187.59
1,4/13/2023,,POS WD  DUTCH BROS             541-955-4700 ORUS,10,,Posted,209.03
1,4/11/2023,,POS WD  WWW COSTCO COM         800-955-2292 WAUS,292.31,,Posted,219.03
1,4/11/2023,,POS WD APPLE COM ONE APPLE PARK WAY US  CUPERTINO    CAUS,4.99,,Posted,511.34
1,4/11/2023,,External WD DISCOVER DC PYMNTS DCIINTNET - E-PAYMENT,130,,Posted,516.33
1,4/10/2023,,POS WD  COSTCO GAS #0025       RENO         NVUS,43.17,,Posted,646.33
1,4/10/2023,,Deposit Internet Transfer from xxx0643,,27.15,Posted,689.5
1,4/10/2023,,External WD AMERICANEXPRESS PERSONAL SAVINGS - TRANSFER,100,,Posted,662.35
1,4/10/2023,,POS WD  EGG ROLL KING          RENO         NVUS,23.02,,Posted,762.35
1,4/8/2023,,POS WD  VENMO*                 Visa Direct  NYUS,157.47,,Posted,785.37
1,4/8/2023,,Deposit costco,,157.47,Posted,942.84
1,4/8/2023,,POS WD  COSTCO WHSE #0025      RENO         NVUS,3.24,,Posted,785.37
1,4/8/2023,,POS WD  SEATGEEK EVENT TICKETS HTTPSSEATGEEKNYUS,350.76,,Posted,788.61
1,4/8/2023,,Deposit Addis part of fob tickets,,175.38,Posted,1139.37
1,4/7/2023,,POS WD SAVE MART #554 RENO NV 4995 KIETZKE LANE      RENO         N,7.99,,Posted,963.99
1,4/7/2023,,External DP VENMO  - CASHOUT,,146.16,Posted,971.98
1,4/7/2023,,Withdrawal Internet Transfer to xxx0643,50,,Posted,825.82
1,4/7/2023,,POS WD  CHEWY.COM              800-672-4399 FLUS,57.84,,Posted,875.82
1,4/6/2023,,Deposit Morgans bday,,100,Posted,933.66
1,4/6/2023,,Withdrawal repay savings Costco Gas Morgan Bday groceries,541.07,,Posted,833.66
1,4/6/2023,,POS WD  ANTHEM BLUE INDIVIDUAL 844-507-8474 INUS,41.93,,Posted,1374.73
1,4/5/2023,,POS WD SMITHS FOOD # 4344 175 LEMMON DRIVE       RENO         NVUS,7.98,,Posted,1416.66
1,4/5/2023,,POS WD SMITHS FOOD # 4344 175 LEMMON DRIVE       RENO         NVUS,28.8,,Posted,1424.64
1,4/5/2023,,POS WD  VENMO*                 Visa Direct  NYUS,23,,Posted,1453.44
1,4/5/2023,,"External DP FISHER,MAYA PERSONAL SAVINGS - TRANSFER",,24,Posted,1476.44
1,4/5/2023,,External DP ASSIST-2-SELL IN WRS667 02761ASSIS001 - Payroll,,1471.15,Posted,1452.44
1,4/4/2023,,"External DP FISHER,MAYA PERSONAL SAVINGS - TRANSFER",,50,Posted,-18.71
1,4/4/2023,,Max OD Access Fee (SYS)  METLIFE PET            HTTPSWWW.PETFINUS,35,,Posted,-68.71
1,4/4/2023,,Overdraft Protection Deposit,,0.07,Posted,-33.71
1,4/4/2023,,POS WD  METLIFE PET            HTTPSWWW.PETFINUS,35.66,,Posted,-33.78
1,4/3/2023,,External WD GEICO  - PREM COLL,112.88,,Posted,1.88
1,4/1/2023,,POS WD  IC* INSTACART          HTTPSINSTACARCAUS,29.18,,Posted,114.76
1,3/31/2023,,Descriptive Deposit Cash Back Reward,,10,Posted,143.94
1,3/30/2023,,ATM Deposit GREATER NEVADA CU 1095 N HILLS BLVD      RENO         NVUS,,30,Posted,133.94
1,3/30/2023,,POS WD  COSTCO WHSE #0025      RENO         NVUS,40.53,,Posted,103.94
1,3/29/2023,,POS WD  VENMO*                 Visa Direct  NYUS,18.5,,Posted,144.47
1,3/29/2023,,"POS WD  ELLEN B. MCBRIDE, A PRORENO         NVUS",100,,Posted,162.97
1,3/28/2023,,Deposit Internet Transfer from xxx0643,,51,Posted,262.97
1,3/28/2023,,External WD NV ENERGY NORTH SPPCO - SPPC PYMT,141.91,,Posted,211.97
1,3/27/2023,,External WD DISCOVER DC PYMNTS DCIINTNET - E-PAYMENT,128.87,,Posted,353.88
1,3/27/2023,,External DP VENMO  - CASHOUT,,47.3,Posted,482.75
1,3/27/2023,,External DP VENMO  - CASHOUT,,47.3,Posted,435.45
1,3/26/2023,,POS WD  L ESSENCE DAY SPA AND SRENO         NVUS,112.4,,Posted,388.15
1,3/25/2023,,POS WD  ROSS STORES #855       RENO         NVUS,71.39,,Posted,500.55
1,3/25/2023,,POS WD  DD DOORDASH LOSCUATRO  855-973-1040 CAUS,19.15,,Posted,571.94
1,3/25/2023,,POS WD  VZWRLSS*APOCC VISW     800-922-0204 FLUS,106.54,,Posted,591.09
1,3/24/2023,,POS WD SMITHS FOOD # 4344 175 LEMMON DRIVE       RENO         NVUS,1.65,,Posted,697.63
1,3/24/2023,,POS WD  VENMO*                 Visa Direct  NYUS,760.02,,Posted,699.28
1,3/22/2023,,POS WD SAVE MART #554 RENO NV 4995 KIETZKE LANE      RENO         N,4.58,,Posted,1459.3
1,3/22/2023,,External WD FARMERS INS  - EFT PYMT,17.21,,Posted,1463.88
1,3/21/2023,,POS WD  Roku for WarnerMedia Gl816-2728107  DEUS,9.99,,Posted,1481.09
1,3/21/2023,,IAT Withdrawal IAT PAYPAL  1025889043832  CODEFINITY,7,,Posted,1491.08
1,3/21/2023,,POS WD  DMV-44                 775-684-4513 NVUS,72,,Posted,1498.08
1,3/20/2023,,POS WD SMITHS FOOD # 4344 175 LEMMON DRIVE       RENO         NVUS,5,,Posted,1570.08
1,3/20/2023,,POS WD ULTA #1167 4891 KIETZKE LANE      RENO         NVUS,55.22,,Posted,1575.08
1,3/20/2023,,POS WD SAVE MART #554 RENO NV 4995 KIETZKE LANE      RENO         N,10.49,,Posted,1630.3
1,3/20/2023,,External DP VENMO  - CASHOUT,,14,Posted,1640.79
1,3/20/2023,,External DP ASSIST-2-SELL IN WRS667 02761ASSIS001 - Payroll,,1471.15,Posted,1626.79
1,3/19/2023,,POS WD SMITHS FOOD # 4344 175 LEMMON DRIVE       RENO         NVUS,8.28,,Posted,155.64
1,3/18/2023,,POS WD  DD DOORDASH GOLDENFLO  855-973-1040 CAUS,38.77,,Posted,163.92
1,3/18/2023,,POS WD  COSTCO WHSE #0025      RENO         NVUS,94.32,,Posted,202.69
1,3/17/2023,,POS WD SMITHS FOOD # 4344 175 LEMMON DRIVE       RENO         NVUS,11.01,,Posted,297.01
1,3/17/2023,,POS WD  APPLE.COM/BILL         408-974-1010 CAUS,2.99,,Posted,308.02
1,3/16/2023,,POS WD  COSTCO WHSE #0025      RENO         NVUS,3.24,,Posted,311.01
1,3/15/2023,,POS WD SMITHS FOOD # 4344 175 LEMMON DRIVE       RENO         NVUS,2.41,,Posted,314.25
1,3/15/2023,,POS WD  NETFLIX COM            LOS GATOS    CAUS,15.49,,Posted,316.66
1,3/15/2023,,POS WD SAVE MART #554 RENO NV 4995 KIETZKE LANE      RENO         N,24.96,,Posted,332.15
1,3/15/2023,,IAT Withdrawal IAT PAYPAL  1025821395101  RAHUL NAIR,36.74,,Posted,357.11
1,3/15/2023,,POS WD  VSP 800-785-0699       800-785-0699 TXUS,13.84,,Posted,393.85
1,3/15/2023,,POS WD  SPOTIFY                877-778-1161 NYUS,9.99,,Posted,407.69
1,3/14/2023,,POS WD  DD DOORDASH THAILOTUS  855-973-1040 CAUS,23.51,,Posted,417.68
1,3/14/2023,,External DP VENMO  - CASHOUT,,65.36,Posted,441.19
1,3/12/2023,,POS WD  WINCO FOODS #17 2855 N Reno         NVUS,21.36,,Posted,375.83
1,3/11/2023,,POS WD  APPLE.COM/BILL         866-712-7753 CAUS,4.99,,Posted,397.19
1,3/11/2023,,POS WD SMITHS FOOD # 4344 175 LEMMON DRIVE       RENO         NVUS,148.12,,Posted,402.18
1,3/11/2023,,POS WD  BELINE CARNICERIA &amp;amp; DELRENO         NVUS,12.98,,Posted,550.3
1,3/10/2023,,POS WD MCDONALD'S F10489 120 LEMMON DR          RENO         NVUS,3.67,,Posted,563.28
1,3/9/2023,,POS WD MCDONALD'S F5023 5000 S VIRGINIA        RENO         NVUS,4.74,,Posted,566.95
1,3/9/2023,,POS WD  Amazon.com*H50TI67O1   Amzn.com/billWAUS,9.99,,Posted,571.69
1,3/8/2023,,POS WD SAVE MART #554 RENO NV 4995 KIETZKE LANE      RENO         N,4.99,,Posted,581.68
1,3/8/2023,,External WD AMERICANEXPRESS PERSONAL SAVINGS - TRANSFER,100,,Posted,586.67
1,3/8/2023,,POS WD  VENMO*                 Visa Direct  NYUS,110.07,,Posted,686.67
1,3/8/2023,,POS WD  VENMO*                 Visa Direct  NYUS,25.83,,Posted,796.74
1,3/7/2023,,POS WD  AMAZON.COM             SEATTLE      WAUS,17.31,,Posted,822.57
1,3/7/2023,,Withdrawal Internet Transfer to xxx0643,50,,Posted,839.88
1,3/7/2023,,POS WD  ANTHEM BLUE INDIVIDUAL 844-507-8474 INUS,41.93,,Posted,889.88
1,3/6/2023,,POS WD SAVE MART #554 RENO NV 4995 KIETZKE LANE      RENO         N,7.68,,Posted,931.81
1,3/6/2023,,POS WD  SP REMI                HTTPSREMICLUBCAUS,53.05,,Posted,939.49
1,3/6/2023,,External WD DISCOVER DC PYMNTS DCIINTNET - E-PAYMENT,403.84,,Posted,992.54
1,3/6/2023,,External WD PAYPAL INSTANT TRANSFER - INST XFER,83.42,,Posted,1396.38
1,3/4/2023,,POS WD  METLIFE PET            HTTPSWWW.PETFINUS,35.66,,Posted,1479.8
1,3/3/2023,,POS WD  DUTCH BROS             541-955-4700 ORUS,10,,Posted,1515.46
1,3/3/2023,,External WD DISCOVER DC PYMNTS DCIINTNET - E-PAYMENT,90.01,,Posted,1525.46
1,3/3/2023,,External DP VENMO  - CASHOUT,,21.5,Posted,1615.47
1,3/3/2023,,External DP ASSIST-2-SELL IN WRS667 02761ASSIS001 - Payroll,,1471.15,Posted,1593.97
1,3/2/2023,,POS WD  DD DOORDASH LOSCUATRO  855-973-1040 CAUS,15.65,,Posted,122.82
1,3/2/2023,,External WD GEICO  - PREM COLL,111.82,,Posted,138.47
1,3/2/2023,,POS WD  UBER   EATS            HELP.UBER.COMCAUS,50.41,,Posted,250.29
1,3/1/2023,,External WD NV ENERGY NORTH SPPCO - SPPC PYMT,142.07,,Posted,300.7
1,2/28/2023,,Descriptive Deposit Cash Back Reward,,10,Posted,442.77
1,2/27/2023,,NOW Withdrawal  Zelle To TOBIN SCHULTZ +1-800-421-6674,99,,Posted,432.77
1,2/27/2023,,External WD PAYPAL INSTANT TRANSFER - INST XFER,20.08,,Posted,531.77
1,2/27/2023,,External DP VENMO  - CASHOUT,,9.51,Posted,551.85
1,2/27/2023,,External DP VENMO  - CASHOUT,,94.72,Posted,542.34
1,2/26/2023,,POS WD  DD DOORDASH ELPAISANO  855-973-1040 CAUS,25.46,,Posted,447.62
1,2/26/2023,,POS WD  VENMO*                 Visa Direct  NYUS,43.42,,Posted,473.08
1,2/25/2023,,POS WD  AMZN Mktp US*HP93V3722 Amzn.com/billWAUS,2.98,,Posted,516.5
1,2/25/2023,,POS WD  VZWRLSS*APOCC VISW     800-922-0204 FLUS,106.54,,Posted,519.48
1,2/24/2023,,POS WD SMITHS FOOD # 4344 175 LEMMON DRIVE       RENO         NVUS,27.61,,Posted,626.02
1,2/24/2023,,POS WD  VENMO*                 Visa Direct  NYUS,767.42,,Posted,653.63
1,2/24/2023,,Deposit Internet Transfer from xxx0643,,760,Posted,1421.05
1,2/24/2023,,"POS WD  ELLEN B. MCBRIDE, A PRORENO         NVUS",100,,Posted,661.05
1,2/24/2023,,POS WD SAVE MART #554 RENO NV 4995 KIETZKE LANE      RENO         N,27.48,,Posted,761.05
1,2/22/2023,,NOW Deposit  Zelle From IHC-Metlife Pet +1-800-421-6674,,91.16,Posted,788.53
1,2/21/2023,,POS WD  SQ *DEATH VALLEY COFFEEBEATTY       NVUS,9.53,,Posted,697.37
1,2/21/2023,,POS WD  CHEVRON/3 DESERTS TONOPTONOPAH      NVUS,4.78,,Posted,706.9
1,2/21/2023,,External WD FARMERS INS  - EFT PYMT,17.21,,Posted,711.68
1,2/20/2023,,POS WD  Roku for WarnerMedia Gl816-2728107  DEUS,9.99,,Posted,728.89
1,2/18/2023,,POS WD  Death Valley Natural HiDeath Valley CAUS,5.87,,Posted,738.88
1,2/18/2023,,POS WD  Subway 48688           Tonopah      NVUS,6.82,,Posted,744.75
1,2/18/2023,,POS WD  CHEVRON/3 DESERTS TONOPTONOPAH      NVUS,3.49,,Posted,751.57
1,2/18/2023,,POS WD  TST* Hinoki Sushi      Reno         NVUS,20.96,,Posted,755.06
1,2/18/2023,,POS WD WAL-MART #4239 250 VISTA KNOLL PARKWAYRENO         NVUS,54.48,,Posted,776.02
1,2/17/2023,,POS WD SMITHS FOOD # 4344 175 LEMMON DRIVE       RENO         NVUS,2.49,,Posted,830.5
1,2/17/2023,,Withdrawal Internet Transfer to xxx0643,760,,Posted,832.99
1,2/17/2023,,External DP ASSIST-2-SELL IN WRS667 02761ASSIS001 - Payroll,,1471.15,Posted,1592.99
1,2/17/2023,,POS WD  APPLE.COM/BILL         866-712-7753 CAUS,2.99,,Posted,121.84
1,2/15/2023,,POS WD  WINCO FOODS #17 2855 N Reno         NVUS,51.43,,Posted,124.83
1,2/15/2023,,POS WD  Netflix.com            866-5797172  CAUS,15.49,,Posted,176.26
1,2/15/2023,,"External DP FISHER,MAYA PERSONAL SAVINGS - TRANSFER",,150,Posted,191.75
1,2/15/2023,,POS WD  VSP 800-785-0699       800-785-0699 TXUS,13.84,,Posted,41.75
1,2/15/2023,,POS WD  SPOTIFY                877-778-1161 NYUS,9.99,,Posted,55.59
1,2/14/2023,,POS WD SAVE MART #554 RENO NV 4995 KIETZKE LANE      RENO         N,12.65,,Posted,65.58
1,2/14/2023,,External DP VENMO  - CASHOUT,,4.47,Posted,78.23
1,2/12/2023,,POS WD  VENMO*                 Visa Direct  NYUS,100.24,,Posted,73.76
1,2/12/2023,,Deposit Internet Transfer from xxx0643,,80,Posted,174
1,2/12/2023,,POS WD  VENMO*                 Visa Direct  NYUS,7,,Posted,94
1,2/12/2023,,Deposit Internet Transfer from xxx0643,,50,Posted,101
1,2/11/2023,,POS WD APPLE COM ONE APPLE PARK WAY US  CUPERTINO    CAUS,4.99,,Posted,51
1,2/11/2023,,POS WD  WEB*Hostgator.com      713-5745287  MAUS,17.95,,Posted,55.99
1,2/11/2023,,POS WD  FS *filestar           877-3278914  CAUS,9,,Posted,73.94
1,2/11/2023,,POS WD  PP*DUTCH BROS NV0601   GRANTS PASS  ORUS,1,,Posted,82.94
1,2/10/2023,,POS WD  Subway 3157            Reno         NVUS,10.75,,Posted,83.94
1,2/8/2023,,POS WD  RAISING CANE'S 432     RENO         NVUS,11.9,,Posted,94.69
1,2/8/2023,,External WD AMERICANEXPRESS PERSONAL SAVINGS - TRANSFER,100,,Posted,106.59
1,2/8/2023,,External DP VENMO  - CASHOUT,,23.31,Posted,206.59
1,2/7/2023,,POS WD 7-ELEVEN 6150 S. MCCARRAN   US  RENO         NVUS,2.69,,Posted,183.28
1,2/7/2023,,Withdrawal Internet Transfer to xxx0643,50,,Posted,185.97
1,2/7/2023,,POS WD  ANTHEM BLUE INDIVIDUAL 844-507-8474 INUS,41.93,,Posted,235.97
1,2/6/2023,,POS WD VCA ANIMAL 4792 CAUGHLIN PKWY US  RENO         NVUS,363.95,,Posted,277.9
1,2/6/2023,,POS WD  WINCO FOODS #12 9750 SOReno         NVUS,65.58,,Posted,641.85
1,2/6/2023,,POS WD  Subway 3157            Reno         NVUS,17.25,,Posted,707.43
1,2/6/2023,,External WD DISCOVER DC PYMNTS DCIINTNET - E-PAYMENT,468.81,,Posted,724.68
1,2/5/2023,,POS WD  VENMO*                 Visa Direct  NYUS,137.59,,Posted,1193.49
1,2/5/2023,,POS WD  VENMO*                 Visa Direct  NYUS,49.01,,Posted,1331.08
1,2/5/2023,,POS WD  COSTCO WHSE #0025      RENO         NVUS,9.71,,Posted,1380.09
1,2/4/2023,,POS WD  AMAZON.COM             SEATTLE      WAUS,25.21,,Posted,1389.8
1,2/4/2023,,POS WD  METLIFE PET            HTTPSWWW.PETFINUS,35.66,,Posted,1415.01
1,2/3/2023,,Withdrawal Internet Transfer to xxx0643,26.37,,Posted,1450.67
1,2/3/2023,,POS WD  DUTCH BROS             541-955-4700 ORUS,10,,Posted,1477.04
1,2/3/2023,,External DP ASSIST-2-SELL IN WRS667 02761ASSIS001 - Payroll,,1471.15,Posted,1487.04
1,2/2/2023,,POS WD MCDONALD'S F5023 5000 S VIRGINIA        RENO         NVUS,4.21,,Posted,15.89
1,2/2/2023,,POS WD SAVE MART #554 RENO NV 4995 KIETZKE LANE      RENO         N,8.29,,Posted,20.1
1,2/2/2023,,POS WD  TST* Hinoki Sushi      Reno         NVUS,28.86,,Posted,28.39
1,2/2/2023,,External WD GEICO  - PREM COLL,87.78,,Posted,57.25
1,2/1/2023,,Descriptive Deposit Cash Back Reward,,10,Posted,145.03
1,1/31/2023,,POS WD SMITHS FOOD # 4344 175 LEMMON DRIVE       RENO         NVUS,3.99,,Posted,135.03
1,1/31/2023,,POS WD  Subway 3157            Reno         NVUS,14.65,,Posted,139.02
1,1/30/2023,,POS WD SAVE MART #554 RENO NV 4995 KIETZKE LANE      RENO         N,15.93,,Posted,153.67
1,1/30/2023,,POS WD  VENMO*                 Visa Direct  NYUS,57.91,,Posted,169.6
1,1/29/2023,,POS WD  L ESSENCE DAY SPA AND SRENO         NVUS,44.4,,Posted,227.51
1,1/28/2023,,POS WD  AMZN Mktp US*L91Y240N3 Amzn.com/billWAUS,9.73,,Posted,271.91
1,1/28/2023,,POS WD  AMZN Mktp US*XN2E57WP3 Amzn.com/billWAUS,27.04,,Posted,281.64
1,1/28/2023,,POS WD  JACK IN THE BOX 7316   RENO         NVUS,25.18,,Posted,308.68
1,1/28/2023,,POS WD  QDOBA 2475             RENO         NVUS,15.27,,Posted,333.86
1,1/28/2023,,POS WD  AMZN Mktp US*HS4QP7413 Amzn.com/billWAUS,21.36,,Posted,349.13
1,1/27/2023,,POS WD  RAISING CANE'S 432     RENO         NVUS,11.9,,Posted,370.49
1,1/26/2023,,POS WD  COSTCO GAS #0025       RENO         NVUS,45.8,,Posted,382.39
1,1/26/2023,,External WD NV ENERGY NORTH SPPCO - SPPC PYMT,140.53,,Posted,428.19
1,1/26/2023,,POS WD  CHEWY.COM              800-672-4399 FLUS,22.81,,Posted,568.72
1,1/25/2023,,POS WD  Subway 3157            Reno         NVUS,15.94,,Posted,591.53
1,1/25/2023,,POS WD  VZWRLSS*APOCC VISW     800-922-0204 FLUS,106.54,,Posted,607.47
1,1/25/2023,,POS WD SAVE MART #554 RENO NV 4995 KIETZKE LANE      RENO         N,18.06,,Posted,714.01
1,1/25/2023,,External DP VENMO  - CASHOUT,,93.34,Posted,732.07
1,1/24/2023,,Withdrawal Internet Transfer to xxx0643,50,,Posted,638.73
1,1/24/2023,,POS WD  VENMO*                 Visa Direct  NYUS,756.49,,Posted,688.73
1,1/24/2023,,POS WD  VENMO*                 Visa Direct  NYUS,49.76,,Posted,1445.22
1,1/23/2023,,POS WD  STEAMGAMES.COM 42595229425-8899642  WAUS,9.74,,Posted,1494.98
1,1/22/2023,,POS WD  SALADWORKS - RENO      RENO         NVUS,32.46,,Posted,1504.72
1,1/21/2023,,POS WD  SHELL SERVICE STATION  RENO         NVUS,5.5,,Posted,1537.18
1,1/21/2023,,POS WD  TST* Hinoki Sushi      Reno         NVUS,21.8,,Posted,1542.68
1,1/21/2023,,POS WD WAL-MART #3254 5260 W 7TH ST          RENO         NVUS,4.47,,Posted,1564.48
1,1/21/2023,,POS WD  SAFEWAY #1210          RENO         NVUS,14.94,,Posted,1568.95
1,1/21/2023,,POS WD  ROSS STORES #855       RENO         NVUS,44.35,,Posted,1583.89
1,1/21/2023,,POS WD  SALLY BEAUTY 103 206 LERENO         NVUS,11.9,,Posted,1628.24
1,1/20/2023,,POS WD  Roku for WarnerMedia Gl816-2728107  DEUS,9.99,,Posted,1640.14
1,1/20/2023,,External WD FARMERS INS  - EFT PYMT,17.21,,Posted,1650.13
1,1/20/2023,,External DP ASSIST-2-SELL IN WRS667 02761ASSIS001 - Payroll,,1471.15,Posted,1667.34
1,1/19/2023,,POS WD SMITHS FOOD # 4344 175 LEMMON DRIVE       RENO         NVUS,11.16,,Posted,196.19
1,1/18/2023,,POS WD SAVE MART #554 RENO NV 4995 KIETZKE LANE      RENO         N,13.16,,Posted,207.35
1,1/18/2023,,External WD DISCOVER DC PYMNTS DCIINTNET - E-PAYMENT,91,,Posted,220.51
1,1/17/2023,,External DP VENMO  - CASHOUT,,25.96,Posted,311.51
1,1/16/2023,,POS WD  IC* INSTACART          HTTPSINSTACARCAUS,52.71,,Posted,285.55
1,1/16/2023,,POS WD SMITHS FOOD # 4344 175 LEMMON DRIVE       RENO         NVUS,27.28,,Posted,338.26
1,1/16/2023,,POS WD SMITHS FOOD # 4344 175 LEMMON DRIVE       RENO         NVUS,2.15,,Posted,365.54
1,1/16/2023,,POS WD APPLE COM ONE APPLE PARK WAY US  CUPERTINO    CAUS,2.99,,Posted,367.69
1,1/15/2023,,POS WD SMITHS FOOD # 4344 175 LEMMON DRIVE       RENO         NVUS,15.06,,Posted,370.68
1,1/15/2023,,POS WD  NETFLIX COM            LOS GATOS    CAUS,15.49,,Posted,385.74
1,1/15/2023,,POS WD  VSP 800-785-0699       800-785-0699 TXUS,13.84,,Posted,401.23
1,1/15/2023,,POS WD  SPOTIFY                877-778-1161 NYUS,9.99,,Posted,415.07
1,1/14/2023,,POS WD SMITHS FOOD # 4344 175 LEMMON DRIVE       RENO         NVUS,25.63,,Posted,425.06
1,1/14/2023,,POS WD  WINCO FOODS #17 2855 N Reno         NVUS,92.88,,Posted,450.69
1,1/14/2023,,POS WD  RAISING CANE'S 432     RENO         NVUS,11.9,,Posted,543.57
1,1/13/2023,,ATM Deposit GREATER NEVADA CU 1095 N HILLS BLVD      RENO         NVUS,,300,Posted,555.47
1,1/13/2023,,POS WD  COSTCO GAS #0025       RENO         NVUS,44.42,,Posted,255.47
1,1/12/2023,,POS WD SMITHS FOOD # 4344 175 LEMMON DRIVE       RENO         NVUS,5.28,,Posted,299.89
1,1/12/2023,,POS WD  IC* INSTACART          HTTPSINSTACARCAUS,3,,Posted,305.17
1,1/12/2023,,POS WD  Subway 3157            Reno         NVUS,14.26,,Posted,308.17
1,1/12/2023,,POS WD  AMZN Mktp US*JW5JX5EC3 Amzn.com/billWAUS,10.82,,Posted,322.43
1,1/12/2023,,POS WD  AMZN Mktp US*KN5RW3CT3 Amzn.com/billWAUS,8.65,,Posted,333.25
1,1/12/2023,,POS WD  IC* INSTACART          HTTPSINSTACARCAUS,24.31,,Posted,341.9
1,1/11/2023,,ATM Deposit GREATER NEVADA CU 1095 N HILLS BLVD      RENO         NVUS,,330,Posted,366.21
1,1/11/2023,,POS WD  VENMO*                 San Jose     CAUS,20,,Posted,36.21
1,1/11/2023,,POS WD  WEB*Hostgator.com      713-5745287  MAUS,17.95,,Posted,56.21
1,1/11/2023,,POS WD  FS *filestar           877-3278914  CAUS,9,,Posted,74.16
1,1/10/2023,,Deposit Internet Transfer from xxx0643,,35,Posted,83.16
1,1/10/2023,,External WD AMERICANEXPRESS PERSONAL SAVINGS - TRANSFER,100,,Posted,48.16
1,1/10/2023,,POS WD  BARNES&amp;amp;NOBLE PAPERSOURC800-843-2665 NYUS,19.3,,Posted,148.16
1,1/9/2023,,Deposit Internet Transfer from xxx0643,,30,Posted,167.46
1,1/9/2023,,Deposit Internet Transfer from xxx0643,,40,Posted,137.46
1,1/9/2023,,External DP VENMO  - CASHOUT,,26.59,Posted,97.46
1,1/9/2023,,External DP VENMO  - CASHOUT,,51.57,Posted,70.87
1,1/9/2023,,POS WD  AUNTIE ANNE'S NV118    RENO         NVUS,6.4,,Posted,19.3
1,1/9/2023,,POS WD  WETZEL'S PRETZELS #K104RENO         NVUS,6.05,,Posted,25.7
1,1/9/2023,,POS WD  CRUZ KITCHEN           RENO         NVUS,8.77,,Posted,31.75
1,1/8/2023,,Overdraft Protection Deposit,,19.3,Posted,40.52
1,1/8/2023,,Overdraft Protection Deposit,,2.07,Posted,21.22
1,1/8/2023,,POS WD  ROSS STORES #855       RENO         NVUS,28.12,,Posted,19.15
1,1/8/2023,,POS WD ULTA #1166 5110 MAE ANNE AVE #601 RENO         NVUS,12.98,,Posted,47.27
1,1/8/2023,,POS WD  436 FOREVER 21        RENO         NVUS,54.12,,Posted,60.25
1,1/8/2023,,POS WD  H&amp;amp;M0325                RENO         NVUS,34.07,,Posted,114.37
1,1/8/2023,,"POS WD  MEADOWOOD MALL, 5000 MERENO         NVUS",37.83,,Posted,148.44
1,1/8/2023,,POS WD  VICTORIA'S SECRET 0381 RENO         NVUS,36.23,,Posted,186.27
1,1/8/2023,,POS WD HOT TOPIC 0187 5000 MEADOWWOOD MALL CIRENO         NVUS,33.42,,Posted,222.5
1,1/8/2023,,POS WD TARGET T-1363 6845 Sierra Center PkwyReno         NVUS,33.42,,Posted,255.92
1,1/8/2023,,POS WD  L ESSENCE DAY SPA AND SRENO         NVUS,172.8,,Posted,289.34
1,1/8/2023,,POS WD  APPLE.COM/BILL         866-712-7753 CAUS,4.99,,Posted,462.14
1,1/7/2023,,POS WD  TST* COSTA VIDA- RENO  RENO         NVUS,20.16,,Posted,467.13
1,1/7/2023,,Withdrawal Internet Transfer to xxx0643,50,,Posted,487.29
1,1/6/2023,,POS WD  PETCO 304              RENO         NVUS,21.31,,Posted,537.29
1,1/6/2023,,POS WD  Amazon.com*A28K496Q3   Amzn.com/billWAUS,15.29,,Posted,558.6
1,1/6/2023,,POS WD  Sally Beauty Supply LLC866-234-9442 TXUS,12.31,,Posted,573.89
1,1/6/2023,,POS WD  AMZN Mktp US*9Z9GG9ZL3 Amzn.com/billWAUS,9.69,,Posted,586.2
1,1/6/2023,,POS WD  Amazon.com*FI5N379F3   Amzn.com/billWAUS,19.47,,Posted,595.89
1,1/5/2023,,POS WD  AMZN Mktp US*NA1VI8PG3 Amzn.com/billWAUS,6.81,,Posted,615.36
1,1/5/2023,,POS WD  VENMO*                 Visa Direct  NYUS,17,,Posted,622.17
1,1/5/2023,,POS WD  COSTCO WHSE #0025      RENO         NVUS,178.7,,Posted,639.17
1,1/4/2023,,POS WD  CHEWY.COM              800-672-4399 FLUS,43.3,,Posted,817.87
1,1/4/2023,,POS WD  TRADER JOE'S # 082     RENO         NVUS,80,,Posted,861.17
1,1/3/2023,,POS WD  METLIFE PET            HTTPSWWW.PETFINUS,37.66,,Posted,941.17
1,1/3/2023,,POS WD  CHEWY.COM              800-672-4399 FLUS,122.4,,Posted,978.83
1,1/3/2023,,POS WD  RAISING CANE'S 432     RENO         NVUS,24.98,,Posted,1101.23
1,1/3/2023,,External DP GreaterNevada  - E-DEPOSIT,,25,Posted,1126.21
1,1/3/2023,,External WD GEICO  - PREM COLL,87.77,,Posted,1101.21
1,1/3/2023,,POS WD  Amazon.com*SS7CT6193   Amzn.com/billWAUS,76.06,,Posted,1188.98
1,1/1/2023,,POS WD  Subway COO54992        Stead        NVUS,13.88,,Posted,1265.04
1,1/1/2023,,POS WD Wal-Mart Super Center 4239 WAL-SAMS          RENO         NV,6.86,,Posted,1278.92
1,1/1/2023,,POS WD WM SUPERCENTER #4239 Wal-Mart Super Center  RENO         NVU,51.88,,Posted,1285.78
1,1/1/2023,,POS WD  GRUBHUBEGGROLLKING     GRUBHUB.COM  NYUS,25.38,,Posted,1337.66
1,12/31/2022,,Descriptive Deposit Cash Back Reward,,10,Posted,1363.04
1,12/31/2022,,POS WD  VENMO*                 Visa Direct  NYUS,78.37,,Posted,1353.04
1,12/31/2022,,POS WD  WETZEL'S PRETZELS #K104RENO         NVUS,8.21,,Posted,1431.41
1,12/30/2022,,POS WD TARGET T-1363 6845 Sierra Center PkwyReno         NVUS,16.1,,Posted,1439.62
1,12/30/2022,,POS WD  BATH AND BODY WORKS 342RENO         NVUS,65.4,,Posted,1455.72
1,12/30/2022,,POS WD  436 FOREVER 21        RENO         NVUS,40.58,,Posted,1521.12
1,12/30/2022,,POS WD WINDSOR FA 5450 MEADOWOODMALL US  RENO         NVUS,75.68,,Posted,1561.7
1,12/30/2022,,POS WD  Amazon.com*670Q87ZQ3   Amzn.com/billWAUS,18.39,,Posted,1637.38
1,12/30/2022,,External DP ASSIST-2-SELL IN WRS667 02761ASSIS001 - Payroll,,1466.04,Posted,1655.77
1,12/30/2022,,POS WD APPLE COM ONE APPLE PARK WAY US  CUPERTINO    CAUS,29.99,,Posted,189.73
1,12/29/2022,,POS WD  L ESSENCE DAY SPA AND SRENO         NVUS,53,,Posted,219.72
1,12/29/2022,,External WD NV ENERGY NORTH SPPCO - SPPC PYMT,112.54,,Posted,272.72
1,12/27/2022,,External DP VENMO  - CASHOUT,,37.51,Posted,385.26
1,12/25/2022,,POS WD  VZWRLSS*APOCC VISW     800-922-0204 FLUS,106.39,,Posted,347.75
1,12/24/2022,,POS WD  VICTORIA'S SECRET 0381 RENO         NVUS,43.2,,Posted,454.14
1,12/24/2022,,POS WD BARNESNOBLE 5555 S. Virginia St.   Reno         NVUS,18.41,,Posted,497.34
1,12/24/2022,,POS WD BARNESNOBLE 5555 S. Virginia St.   Reno         NVUS,13.32,,Posted,515.75
1,12/24/2022,,POS WD  FIVE GUYS NV 1614 QSR  RENO         NVUS,16.66,,Posted,529.07
1,12/23/2022,,POS WD APPLE COM ONE APPLE PARK WAY US  CUPERTINO    CAUS,11.99,,Posted,545.73
1,12/23/2022,,POS WD  AMAZON.COM             SEATTLE      WAUS,40.73,,Posted,557.72
1,12/23/2022,,External DP VENMO  - CASHOUT,,37.51,Posted,598.45
1,12/21/2022,,POS WD  Subway 3157            Reno         NVUS,14.13,,Posted,560.94
1,12/21/2022,,External WD DISCOVER DC PYMNTS DCIINTNET - E-PAYMENT,100,,Posted,575.07
1,12/21/2022,,External DP VENMO  - CASHOUT,,21.44,Posted,675.07
1,12/20/2022,,POS WD  AMZN Mktp US*3V2C37EK3 Amzn.com/billWAUS,14.06,,Posted,653.63
1,12/20/2022,,POS WD  Amazon.com*HZ1KU06W3   Amzn.com/billWAUS,21.64,,Posted,667.69
1,12/20/2022,,POS WD  L ESSENCE DAY SPA AND SRENO         NVUS,10,,Posted,689.33
1,12/20/2022,,POS WD  Roku for WarnerMedia Gl816-2728107  DEUS,9.99,,Posted,699.33
1,12/20/2022,,POS WD  VENMO*                 Visa Direct  NYUS,761.49,,Posted,709.32
1,12/20/2022,,External WD FARMERS INS  - EFT PYMT,17.21,,Posted,1470.81
1,12/20/2022,,External DP ASSIST-2-SELL IN WRS667 02761ASSIS001 - Payroll,,1466.04,Posted,1488.02
1,12/20/2022,,POS WD  SHARKNINJA             8007987398   MAUS,19.72,,Posted,21.98
1,12/19/2022,,POS WD  COSTCO WHSE #0025      RENO         NVUS,42.87,,Posted,41.7
1,12/17/2022,,POS WD  APPLE.COM/BILL         866-712-7753 CAUS,2.99,,Posted,84.57
1,12/17/2022,,POS WD  THE SANDWICH SPOT      RENO         NVUS,15.3,,Posted,87.56
1,12/16/2022,,POS WD TARGET T-1363 6845 Sierra Center PkwyReno         NVUS,38.98,,Posted,102.86
1,12/15/2022,,POS WD SMITHS FOOD # 4344 175 LEMMON DRIVE       RENO         NVUS,2.19,,Posted,141.84
1,12/15/2022,,POS WD SMITHS FOOD # 4344 175 LEMMON DRIVE       RENO         NVUS,2.15,,Posted,144.03
1,12/15/2022,,POS WD  GRUBHUBHINOKIPOKE      GRUBHUB.COM  NYUS,3.4,,Posted,146.18
1,12/15/2022,,POS WD SAVE MART #554 RENO NV 4995 KIETZKE LANE      RENO         N,13.11,,Posted,149.58
1,12/15/2022,,POS WD  VSP 800-785-0699       800-785-0699 TXUS,13.84,,Posted,162.69
1,12/15/2022,,POS WD  NETFLIX COM            LOS GATOS    CAUS,15.49,,Posted,176.53
1,12/15/2022,,POS WD  SPOTIFY                877-778-1161 NYUS,9.99,,Posted,192.02
1,12/14/2022,,POS WD SMITHS FOOD # 4344 175 LEMMON DRIVE       RENO         NVUS,1.53,,Posted,202.01
1,12/14/2022,,POS WD  AMZN Mktp US*8C8SU1473 Amzn.com/billWAUS,28.08,,Posted,203.54
1,12/14/2022,,POS WD  AMZN Mktp US*1G00958K3 Amzn.com/billWAUS,5.4,,Posted,231.62
1,12/14/2022,,Withdrawal Internet Transfer to xxx0643,81,,Posted,237.02
1,12/13/2022,,External DP VENMO  - CASHOUT,,18.25,Posted,318.02
1,12/13/2022,,External DP VENMO  - CASHOUT,,66.81,Posted,299.77
1,12/12/2022,,POS WD SMITHS FOOD # 4344 175 LEMMON DRIVE       RENO         NVUS,6.98,,Posted,232.96
1,12/12/2022,,POS WD  TST* COSTA VIDA- RENO  RENO         NVUS,17.85,,Posted,239.94
1,12/11/2022,,POS WD BED BATH &amp;amp; BEYOND #208 4983 S VIRGINIA ST     RENO         N,21.65,,Posted,257.79
1,12/11/2022,,POS WD ROSS STORES #1978 2863 NORTHTOWNE LANE   RENO         NVUS,164.1,,Posted,279.44
1,12/11/2022,,POS WD  EIG*Hostgator.com      713-5745287  MAUS,17.95,,Posted,443.54
1,12/11/2022,,POS WD  Nintendo CA877183626   800-2553700  WAUS,59.99,,Posted,461.49
1,12/11/2022,,POS WD  Nintendo CA877180016   800-2553700  WAUS,49.99,,Posted,521.48
1,12/11/2022,,POS WD  FS *filestar           877-3278914  CAUS,9,,Posted,571.47
1,12/10/2022,,POS WD  COSTCO WHSE #0025      RENO         NVUS,166.2,,Posted,580.47
1,12/9/2022,,External DP GreaterNevada  - E-DEPOSIT,,250,Posted,746.67
1,12/9/2022,,POS WD SAVE MART #554 RENO NV 4995 KIETZKE LANE      RENO         N,6.49,,Posted,496.67
1,12/9/2022,,POS WD  IC* INSTACART          HTTPSINSTACARCAUS,33.29,,Posted,503.16
1,12/8/2022,,POS WD  AMZN Mktp US*TO45S6UE3 Amzn.com/billWAUS,51.28,,Posted,536.45
1,12/7/2022,,POS WD SMITHS FOOD # 4344 175 LEMMON DRIVE       RENO         NVUS,7.98,,Posted,587.73
1,12/6/2022,,External WD DISCOVER DC PYMNTS DCIINTNET - E-PAYMENT,446.95,,Posted,595.71
1,12/5/2022,,External WD AMERICANEXPRESS PERSONAL SAVINGS - TRANSFER,400,,Posted,1042.66
1,12/5/2022,,POS WD  VENMO*                 San Jose     CAUS,102,,Posted,1442.66
1,12/5/2022,,POS WD  VENMO*                 Visa Direct  NYUS,50,,Posted,1544.66
1,12/5/2022,,"External DP FISHER,MAYA PERSONAL SAVINGS - TRANSFER",,100,Posted,1594.66
1,12/5/2022,,External DP ASSIST-2-SELL IN WRS667 02761ASSIS001 - Payroll,,1466.04,Posted,1494.66
1,12/2/2022,,POS WD  VENMO*                 Visa Direct  NYUS,18,,Posted,28.62
1,12/2/2022,,External WD GEICO  - PREM COLL,87.77,,Posted,46.62
1,12/1/2022,,POS WD  ANTHEM BLUE INDIVIDUAL 844-507-8474 INUS,41.93,,Posted,134.39
1,12/1/2022,,POS WD SMITHS FOOD # 4344 175 LEMMON DRIVE       RENO         NVUS,5.19,,Posted,176.32
1,12/1/2022,,POS WD  PANDA EXPRESS #776     RENO         NVUS,13.59,,Posted,181.51
1,11/30/2022,,Descriptive Deposit Cash Back Reward,,10,Posted,195.1
1,11/30/2022,,POS WD SMITHS FOOD # 4344 175 LEMMON DRIVE       RENO         NVUS,9.08,,Posted,185.1
1,11/30/2022,,Point Of Sale Deposit  AMZN Mktp US           Amzn.com/billWAUS,,6.16,Posted,194.18
1,11/29/2022,,POS WD  SALLY BEAUTY 103 206 LERENO         NVUS,7.31,,Posted,188.02
1,11/29/2022,,POS WD  QDOBA 2368             RENO         NVUS,15.27,,Posted,195.33
1,11/29/2022,,"External DP FISHER,MAYA PERSONAL SAVINGS - TRANSFER",,100,Posted,210.6
1,11/28/2022,,"External DP FISHER,MAYA PERSONAL SAVINGS - TRANSFER",,100,Posted,110.6
1,11/25/2022,,POS WD  VZWRLSS*APOCC VISW     800-922-0204 FLUS,106.5,,Posted,10.6
1,11/23/2022,,POS WD  PILOT #1005            FERNLEY      NVUS,10.32,,Posted,117.1
1,11/22/2022,,Deposit Internet Transfer from xxx0643,,50,Posted,127.42
1,11/22/2022,,POS WD  TRADER JOE'S # 082     RENO         NVUS,36.64,,Posted,77.42
1,11/22/2022,,External WD NV ENERGY NORTH SPPCO - SPPC PYMT,89.45,,Posted,114.06
1,11/21/2022,,POS WD  VENMO*                 Visa Direct  NYUS,226.95,,Posted,203.51
1,11/21/2022,,External WD DISCOVER DC PYMNTS DCIINTNET - E-PAYMENT,500,,Posted,430.46
1,11/21/2022,,External WD AMERICANEXPRESS PERSONAL SAVINGS - TRANSFER,300,,Posted,930.46
1,11/21/2022,,External WD FARMERS INS  - EFT PYMT,17.21,,Posted,1230.46
1,11/21/2022,,External DP VENMO  - CASHOUT,,20,Posted,1247.67
1,11/21/2022,,External DP VENMO  - CASHOUT,,59.64,Posted,1227.67
1,11/20/2022,,POS WD  COSTCO WHSE #0025      RENO         NVUS,8.1,,Posted,1168.03
1,11/20/2022,,POS WD SMITHS FOOD # 4344 175 LEMMON DRIVE       RENO         NVUS,1.8,,Posted,1176.13
1,11/20/2022,,POS WD SMITHS FOOD # 4344 175 LEMMON DRIVE       RENO         NVUS,11.24,,Posted,1177.93
1,11/20/2022,,POS WD  Roku for WarnerMedia Gl816-2728107  DEUS,9.99,,Posted,1189.17
1,11/20/2022,,POS WD  AMZN Mktp US*HI0UY6ES2 Amzn.com/billWAUS,93.17,,Posted,1199.16
1,11/20/2022,,POS WD  AMZN Mktp US*HI1HE2SN1 Amzn.com/billWAUS,19.78,,Posted,1292.33
1,11/19/2022,,POS WD  UBER   EATS            HELP.UBER.COMCAUS,41.36,,Posted,1312.11
1,11/19/2022,,POS WD  SHOPREMI               SHOPREMI.COM CAUS,35.18,,Posted,1353.47
1,11/19/2022,,POS WD SMITHS FOOD # 4344 175 LEMMON DRIVE       RENO         NVUS,17.53,,Posted,1388.65
1,11/18/2022,,POS WD  AMAZON.COM             SEATTLE      WAUS,159.12,,Posted,1406.18
1,11/18/2022,,POS WD  JACK IN THE BOX 7316   RENO         NVUS,12.1,,Posted,1565.3
1,11/18/2022,,POS WD  VENMO*                 San Jose     CAUS,718.33,,Posted,1577.4
1,11/18/2022,,Deposit Internet Transfer from xxx0643,,718.33,Posted,2295.73
1,11/18/2022,,External DP ASSIST-2-SELL IN WRS667 02761ASSIS001 - Payroll,,1466.04,Posted,1577.4
1,11/17/2022,,External DP VENMO  - CASHOUT,,35.71,Posted,111.36
1,11/17/2022,,POS WD  APPLE.COM/BILL         866-712-7753 CAUS,2.99,,Posted,75.65
1,11/17/2022,,POS WD  ADOBE  *CREATIVE CLOUD 408-536-6000 CAUS,29.99,,Posted,78.64
1,11/16/2022,,POS WD SAVE MART #554 RENO NV 4995 KIETZKE LANE      RENO         N,20.76,,Posted,108.63
1,11/15/2022,,Withdrawal,600,,Posted,129.39
1,11/15/2022,,POS WD  TST* JAMBA JUICE - 0498RENO         NVUS,9.35,,Posted,729.39
1,11/15/2022,,POS WD  NETFLIX COM            LOS GATOS    CAUS,15.49,,Posted,738.74
1,11/15/2022,,POS WD  VSP 800-785-0699       800-785-0699 TXUS,27.68,,Posted,754.23
1,11/14/2022,,POS WD  SPOTIFY                877-778-1161 NYUS,9.99,,Posted,781.91
1,11/14/2022,,POS WD  GRUBHUBRAISINGCANESCH  GRUBHUB.COM  NYUS,32.03,,Posted,791.9
1,11/14/2022,,"External DP FISHER,MAYA PERSONAL SAVINGS - TRANSFER",,600,Posted,823.93
1,11/14/2022,,POS WD  DUTCH BROS             541-955-4700 ORUS,10,,Posted,223.93
1,11/12/2022,,POS WD  APPLE.COM/BILL         800-275-2273 CAUS,35.99,,Posted,233.93
1,11/12/2022,,POS WD  EINSTEIN BAGELS 4020   775-8251045  NVUS,10.42,,Posted,269.92
1,11/11/2022,,POS WD  SHELL SERVICE STATION  RENO         NVUS,1.5,,Posted,280.34
1,11/11/2022,,POS WD  ANNA'S TAQUERIA        RENO         NVUS,81.95,,Posted,281.84
1,11/11/2022,,POS WD  EIG*Hostgator.com      713-5745287  MAUS,17.95,,Posted,363.79
1,11/11/2022,,POS WD  FS *filestar           877-3278914  CAUS,9,,Posted,381.74
1,11/10/2022,,POS WD SMITHS FOOD # 4344 175 LEMMON DRIVE       RENO         NVUS,6.78,,Posted,390.74
1,11/10/2022,,POS WD SMITHS FOOD # 4344 175 LEMMON DRIVE       RENO         NVUS,2.15,,Posted,397.52
1,11/10/2022,,External DP VENMO  - CASHOUT,,5.8,Posted,399.67
1,11/10/2022,,External DP VENMO  - CASHOUT,,15.99,Posted,393.87
1,11/8/2022,,POS WD  Steam Purchase         425-9522985  WAUS,8.99,,Posted,377.88
1,11/7/2022,,External WD DISCOVER DC PYMNTS DCIINTNET - E-PAYMENT,250,,Posted,386.87
1,11/7/2022,,POS WD  EGG ROLL KING          RENO         NVUS,37.37,,Posted,636.87
1,11/6/2022,,POS WD  VENMO*                 San Jose     CAUS,61.96,,Posted,674.24
1,11/6/2022,,POS WD  VENMO*                 Visa Direct  NYUS,32.47,,Posted,736.2
1,11/6/2022,,POS WD  FRESH MARKET ON THE GO PHOENIX      AZUS,16.06,,Posted,768.67
1,11/6/2022,,POS WD  SIP COFFEE AND BEER AT 602-3396988  AZUS,3.8,,Posted,784.73
1,11/5/2022,,POS WD  UBER   TRIP            HELP.UBER.COMCAUS,16.9,,Posted,788.53
1,11/5/2022,,POS WD  UBER   TRIP            HELP.UBER.COMCAUS,13.95,,Posted,805.43
1,11/5/2022,,NOW Withdrawal  Zelle To TOBIN SCHULTZ +1-800-421-6674,8,,Posted,819.38
1,11/5/2022,,POS WD  SQ *THR33 SUNS INC     SEDONA       AZUS,11,,Posted,827.38
1,11/4/2022,,POS WD THE ARTISTS KITCHEN SH 313 STATE ROUTE 179 SUISEDONA       A,20.65,,Posted,838.38
1,11/4/2022,,POS WD  WNPA - MONTEZUMA CASTLECamp Verde   AZUS,42.96,,Posted,859.03
1,11/4/2022,,POS WD  TST* Scramble - Tempe  Tempe        AZUS,36.42,,Posted,901.99
1,11/4/2022,,Withdrawal Internet Transfer to xxx0643,718.33,,Posted,938.41
1,11/4/2022,,External DP ASSIST-2-SELL IN WRS667 02761ASSIS001 - Payroll,,1466.04,Posted,1656.74
1,11/3/2022,,POS WD  WHOLEFDS TMP#103 750 S TEMPE        AZUS,3.55,,Posted,190.7
1,11/3/2022,,NOW Withdrawal  Zelle To TOBIN SCHULTZ +1-800-421-6674,56.3,,Posted,194.25
1,11/2/2022,,POS WD  CHANGING HANDS BOOKSTORTEMPE        AZUS,8.63,,Posted,250.55
1,11/2/2022,,External WD GEICO  - PREM COLL,87.77,,Posted,259.18
1,11/2/2022,,POS WD  IT'SUGAR DESERT RIDGE  PHOENIX      AZUS,4.08,,Posted,346.95
1,11/1/2022,,POS WD  VENMO*                 Visa Direct  NYUS,34.45,,Posted,351.03
1,11/1/2022,,POS WD  THE SICILIAN BUTCHER   PHOENIX      AZUS,6.43,,Posted,385.48
1,10/31/2022,,Descriptive Deposit Cash Back Reward,,10,Posted,391.91
1,10/31/2022,,POS WD  VENMO*                 Visa Direct  NYUS,27.04,,Posted,381.91
1,10/31/2022,,POS WD  TST* Varsity Tavern    Tempe        AZUS,12.28,,Posted,408.95
1,10/31/2022,,POS WD  Sally Beauty Supply LLC866-234-9442 TXUS,19.36,,Posted,421.23
1,10/31/2022,,"External DP FISHER,MAYA PERSONAL SAVINGS - TRANSFER",,145,Posted,440.59
1,10/31/2022,,POS WD  VENMO*                 San Jose     CAUS,13,,Posted,295.59
1,10/30/2022,,POS WD  VENMO*                 Visa Direct  NYUS,33.7,,Posted,308.59
1,10/30/2022,,POS WD  VENMO*                 Visa Direct  NYUS,6,,Posted,342.29
1,10/28/2022,,POS WD 999 PHO 2313 KIETZKE LN        RENO         NVUS,8.45,,Posted,348.29
1,10/28/2022,,POS WD  PP*DUTCH BROS NV0601   GRANTS PASS  ORUS,3.69,,Posted,356.74
1,10/27/2022,,POS WD  TST* JAMBA JUICE - 0498RENO         NVUS,9.35,,Posted,360.43
1,10/26/2022,,POS WD  DNH*GODADDY.COM        480-5058855  AZUS,20.17,,Posted,369.78
1,10/26/2022,,POS WD  VENMO*                 Visa Direct  NYUS,10,,Posted,389.95
1,10/26/2022,,External WD NV ENERGY NORTH SPPCO - SPPC PYMT,64.47,,Posted,399.95
1,10/25/2022,,POS WD  AMZN Mktp US*H863H4E52 Amzn.com/billWAUS,95.26,,Posted,464.42
1,10/25/2022,,POS WD  VZWRLSS*APOCC VISW     800-922-0204 FLUS,106.5,,Posted,559.68
1,10/25/2022,,External DP VENMO  - CASHOUT,,21.49,Posted,666.18
1,10/25/2022,,External DP VENMO  - CASHOUT,,31.43,Posted,644.69
1,10/25/2022,,External DP VENMO  - CASHOUT,,35.33,Posted,613.26
1,10/24/2022,,POS WD  eBay O*14-09252-52963  San Jose     CAUS,23.76,,Posted,577.93
1,10/23/2022,,POS WD  WINCO FOODS #17 2855 N Reno         NVUS,49.19,,Posted,601.69
1,10/22/2022,,POS WD  VENMO*                 Visa Direct  NYUS,718.33,,Posted,650.88
1,10/21/2022,,POS WD  Roku for WarnerMedia Gl816-2728107  DEUS,9.99,,Posted,1369.21
1,10/20/2022,,ATM Withdrawal GREATER NEVADA CU 1095 N HILLS BLVD      RENO         NVUS,160,,Posted,1379.2
1,10/20/2022,,POS WD  DUTCH BROS             541-955-4700 ORUS,10,,Posted,1539.2
1,10/20/2022,,External WD FARMERS INS  - EFT PYMT,17.21,,Posted,1549.2
1,10/20/2022,,External DP ASSIST-2-SELL IN WRS667 02761ASSIS001 - Payroll,,1466.04,Posted,1566.41
1,10/18/2022,,POS WD  EINSTEIN BAGELS 4020   775-8251045  NVUS,9.77,,Posted,100.37
1,10/18/2022,,POS WD  PP*DUTCH BROS NV0601   GRANTS PASS  ORUS,6.79,,Posted,110.14
1,10/17/2022,,ATM Foreign Trns Fee (SYS),3,,Posted,116.93
1,10/17/2022,,ATM Withdrawal PAI ISO 2881 NORTHTOWN LANE    RENO         NVUS,103.5,,Posted,119.93
1,10/17/2022,,POS WD  WINCO FOODS #17 2855 N Reno         NVUS,52.65,,Posted,223.43
1,10/17/2022,,POS WD  APPLE.COM/BILL         866-712-7753 CAUS,2.99,,Posted,276.08
1,10/17/2022,,POS WD  GRUBHUBHINOKIPOKE      GRUBHUB.COM  NYUS,36.72,,Posted,279.07
1,10/16/2022,,POS WD SMITHS FOOD # 4344 175 LEMMON DRIVE       RENO         NVUS,48.69,,Posted,315.79
1,10/16/2022,,POS WD  Adobe Inc              800-8336687  CAUS,29.99,,Posted,364.48
1,10/16/2022,,"POS WD  NETFLIX, INC.          186-65797172 CAUS",15.49,,Posted,394.47
1,10/15/2022,,POS WD  DOUGHBOYS DONUTS 2 LLC RENO         NVUS,4.73,,Posted,409.96
1,10/15/2022,,POS WD  SPOTIFY                877-778-1161 NYUS,9.99,,Posted,414.69
1,10/14/2022,,POS WD  PP*DUTCH BROS NV0601   GRANTS PASS  ORUS,6.9,,Posted,424.68
1,10/13/2022,,External DP GreaterNevada  - E-DEPOSIT,,207.16,Posted,431.58
1,10/13/2022,,Withdrawal Internet Transfer to xxx0643,50,,Posted,224.42
1,10/12/2022,,POS WD  VENMO*                 San Jose     CAUS,42.63,,Posted,274.42
1,10/11/2022,,POS WD Walmart.com 702 SW 8th St          Bentonville  ARUS,19.42,,Posted,317.05
1,10/11/2022,,POS WD  APPLE.COM/BILL         866-712-7753 CAUS,3.99,,Posted,336.47
1,10/11/2022,,POS WD  TST* JAMBA JUICE - 0498RENO         NVUS,9.48,,Posted,340.46
1,10/11/2022,,POS WD  EIG*Hostgator.com      713-5745287  MAUS,17.95,,Posted,349.94
1,10/11/2022,,POS WD APPLE COM ONE APPLE PARK WAY US  CUPERTINO    CAUS,3.99,,Posted,367.89
1,10/11/2022,,POS WD  FS *filestar           877-3278914  CAUS,9,,Posted,371.88
1,10/11/2022,,POS WD  PP*DUTCH BROS NV0601   GRANTS PASS  ORUS,1.06,,Posted,380.88
1,10/10/2022,,POS WD SMITHS FOOD # 4344 175 LEMMON DRIVE       RENO         NVUS,15,,Posted,381.94
1,10/10/2022,,POS WD  SP REMI                HTTPSREMICLUBCAUS,111.73,,Posted,396.94
1,10/10/2022,,POS WD  AMZN Mktp US*1K7J50BD1 Amzn.com/billWAUS,15.87,,Posted,508.67
1,10/8/2022,,POS WD  AMZN Mktp US*1K4905G01 Amzn.com/billWAUS,23.81,,Posted,524.54
1,10/8/2022,,POS WD  NEKTER JUICE BAR 8195  209-3296356  NVUS,11.77,,Posted,548.35
1,10/8/2022,,POS WD  SHELL SERVICE STATION  RENO         NVUS,6.44,,Posted,560.12
1,10/8/2022,,POS WD SMITHS FOOD # 4344 175 LEMMON DRIVE       RENO         NVUS,23.82,,Posted,566.56
1,10/7/2022,,POS WD SMITHS FOOD # 4344 175 LEMMON DRIVE       RENO         NVUS,35.66,,Posted,590.38
1,10/7/2022,,External WD DISCOVER DC PYMNTS DCIINTNET - E-PAYMENT,480,,Posted,626.04
1,10/6/2022,,External WD AMERICANEXPRESS PERSONAL SAVINGS - TRANSFER,200,,Posted,1106.04
1,10/6/2022,,POS WD  DUTCH BROS             541-955-4700 ORUS,10,,Posted,1306.04
1,10/6/2022,,POS WD  Amazon.com*1K4S98CX1   Amzn.com/billWAUS,20.13,,Posted,1316.04
1,10/5/2022,,POS WD SMITHS FOOD # 4344 175 LEMMON DRIVE       RENO         NVUS,7.17,,Posted,1336.17
1,10/5/2022,,POS WD  AMAZON.COM             SEATTLE      WAUS,86.6,,Posted,1343.34
1,10/5/2022,,POS WD  AMAZON.COM             SEATTLE      WAUS,43.27,,Posted,1429.94
1,10/5/2022,,POS WD  AMAZON.COM             SEATTLE      WAUS,20.56,,Posted,1473.21
1,10/5/2022,,External DP ASSIST-2-SELL IN WRS667 02761ASSIS001 - Payroll,,1466.05,Posted,1493.77
1,10/3/2022,,External WD GEICO  - PREM COLL,87.77,,Posted,27.72
1,10/2/2022,,POS WD  VENMO*                 San Jose     CAUS,43.64,,Posted,115.49
1,10/2/2022,,Deposit Internet Transfer from xxx0643,,50,Posted,159.13
1,10/2/2022,,POS WD  RALEY S #115 1075 N HILRENO         NVUS,13.36,,Posted,109.13
1,10/2/2022,,POS WD  ROSS STORES #1978      RENO         NVUS,14.06,,Posted,122.49
1,10/1/2022,,POS WD WM SUPERCENTER #4239 Wal-Mart Super Center  RENO         NVU,13.93,,Posted,136.55
1,9/30/2022,,Descriptive Deposit Cash Back Reward,,10,Posted,150.48
1,9/28/2022,,POS WD SMITHS FOOD # 4344 175 LEMMON DRIVE       RENO         NVUS,12.57,,Posted,140.48
1,9/28/2022,,POS WD  WELLFIT*LEMMONVALLEY   RENO         NVUS,260.73,,Posted,153.05
1,9/27/2022,,External DP VENMO  - CASHOUT,,30.25,Posted,413.78
1,9/25/2022,,POS WD  VENMO*                 Visa Direct  NYUS,64.05,,Posted,383.53
1,9/25/2022,,POS WD  VZWRLSS*APOCC VISW     800-922-0204 FLUS,106.63,,Posted,447.58
1,9/23/2022,,External WD NV ENERGY NORTH SPPCO - SPPC PYMT,90.76,,Posted,554.21
1,9/22/2022,,POS WD  TRADER JOE'S # 082     RENO         NVUS,54.96,,Posted,644.97
1,9/22/2022,,POS WD  TST* Hinoki Sushi      Reno         NVUS,19.24,,Posted,699.93
1,9/22/2022,,External DP VENMO  - CASHOUT,,30.25,Posted,719.17
1,9/21/2022,,POS WD SMITHS FOOD # 4344 175 LEMMON DRIVE       RENO         NVUS,5.48,,Posted,688.92
1,9/21/2022,,POS WD  Roku for WarnerMedia Gl816-2728107  DEUS,9.99,,Posted,694.4
1,9/20/2022,,POS WD  VENMO*                 Visa Direct  NYUS,650,,Posted,704.39
1,9/20/2022,,External WD FARMERS INS  - EFT PYMT,17.21,,Posted,1354.39
1,9/20/2022,,External DP ASSIST-2-SELL IN WRS667 02761ASSIS001 - Payroll,,1331.58,Posted,1371.6
1,9/19/2022,,POS WD  AMZN Mktp US*1M1HG5IC1 Amzn.com/billWAUS,7.57,,Posted,40.02
1,9/19/2022,,POS WD  AMAZON.COM             SEATTLE      WAUS,15.69,,Posted,47.59
1,9/19/2022,,POS WD  AMAZON.COM             SEATTLE      WAUS,29.5,,Posted,63.28
1,9/18/2022,,POS WD SMITHS FOOD # 4344 175 LEMMON DRIVE       RENO         NVUS,14.4,,Posted,92.78
1,9/16/2022,,POS WD APPLE COM ONE APPLE PARK WAY US  CUPERTINO    CAUS,2.99,,Posted,107.18
1,9/16/2022,,"POS WD Adobe Park Avenue,345        San Jose     CAUS",29.99,,Posted,110.17
1,9/16/2022,,POS WD  PP*DUTCH BROS NV0601   GRANTS PASS  ORUS,6.79,,Posted,140.16
1,9/15/2022,,POS WD  SPOTIFY                877-778-1161 NYUS,9.99,,Posted,146.95
1,9/14/2022,,POS WD SMITHS FOOD # 4344 175 LEMMON DRIVE       RENO         NVUS,14.28,,Posted,156.94
1,9/14/2022,,POS WD SMITHS FOOD # 4344 175 LEMMON DRIVE       RENO         NVUS,7.82,,Posted,171.22
1,9/13/2022,,POS WD  VENMO*                 Visa Direct  NYUS,27.41,,Posted,179.04
1,9/13/2022,,POS WD  VENMO*                 Visa Direct  NYUS,21.78,,Posted,206.45
1,9/12/2022,,POS WD  VENMO*                 Visa Direct  NYUS,8,,Posted,228.23
1,9/12/2022,,POS WD  NEKTER JUICE BAR 8195  RENO         NVUS,12.06,,Posted,236.23
1,9/12/2022,,POS WD  SQ *SUPERSTITIONS JAVA Reno         NVUS,5,,Posted,248.29
1,9/11/2022,,POS WD CLOUD9 VAPE &amp; SMOKE SH 440 E GOLDEN VALLEY RD#RENO         N,13.36,,Posted,253.29
1,9/11/2022,,POS WD  AMAZON.COM             SEATTLE      WAUS,19.75,,Posted,266.65
1,9/11/2022,,POS WD  AMAZON.COM             SEATTLE      WAUS,14.06,,Posted,286.4
1,9/11/2022,,POS WD  EIG*Hostgator.com      713-5745287  MAUS,17.95,,Posted,300.46
1,9/11/2022,,POS WD  VENMO*                 Visa Direct  NYUS,57.64,,Posted,318.41
1,9/11/2022,,POS WD  VENMO*                 Visa Direct  NYUS,20,,Posted,376.05
1,9/10/2022,,POS WD  PANDA EXPRESS #776     RENO         NVUS,11.96,,Posted,396.05
1,9/9/2022,,POS WD SMITHS FOOD # 4344 175 LEMMON DRIVE       RENO         NVUS,7.57,,Posted,408.01
1,9/9/2022,,POS WD  VENMO*                 Visa Direct  NYUS,60.53,,Posted,415.58
1,9/9/2022,,POS WD  VENMO*                 Visa Direct  NYUS,35,,Posted,476.11
1,9/9/2022,,External DP NV GAME DESIGN L  - PAYROLL,,157.03,Posted,511.11
1,9/6/2022,,External WD AMERICANEXPRESS PERSONAL SAVINGS - TRANSFER,393,,Posted,354.08
1,9/6/2022,,POS WD SAVE MART #554 RENO NV 4995 KIETZKE LANE      RENO         N,15.06,,Posted,747.08
1,9/6/2022,,External WD DISCOVER DC PYMNTS DCIINTNET - E-PAYMENT,393,,Posted,762.14
1,9/5/2022,,POS WD  GALAXY THEATRE LEGENDS SPARKS       NVUS,8.25,,Posted,1155.14
1,9/4/2022,,POS WD SMITHS FOOD # 43 175 LEMMON DRIVE       RENO         NVUS,15.86,,Posted,1163.39
1,9/4/2022,,POS WD  VENMO*                 Visa Direct  NYUS,3,,Posted,1179.25
1,9/4/2022,,POS WD  VENMO*                 Visa Direct  NYUS,53.91,,Posted,1182.25
1,9/3/2022,,POS WD  LES SCHWAB TIRES 1405 ESparks       NVUS,567.53,,Posted,1236.16
1,9/2/2022,,External WD GEICO  - PREM COLL,87.73,,Posted,1803.69
1,9/2/2022,,External DP ASSIST-2-SELL IN WRS667 02761ASSIS001 - Payroll,,1483.45,Posted,1891.42
1,9/1/2022,,POS WD  TRADER JOE'S # 082     RENO         NVUS,7.48,,Posted,407.97
1,9/1/2022,,POS WD  PANDA EXPRESS #776     RENO         NVUS,13.37,,Posted,415.45
1,9/1/2022,,POS WD SMITHS FOOD # 43 175 LEMMON DRIVE       RENO         NVUS,10.42,,Posted,428.82
1,8/31/2022,,Descriptive Deposit Cash Back Reward,,10,Posted,439.24
1,8/31/2022,,POS WD  VENMO*                 Visa Direct  NYUS,43.97,,Posted,429.24
1,8/29/2022,,POS WD  VENMO*                 Visa Direct  NYUS,10.67,,Posted,473.21
1,8/29/2022,,External WD NV ENERGY NORTH SPPCO - SPPC PYMT,104.31,,Posted,483.88
1,8/29/2022,,External WD DISCOVER DC PYMNTS DCIINTNET - E-PAYMENT,50,,Posted,588.19
1,8/27/2022,,NOW Withdrawal  Zelle To TOBIN SCHULTZ +1-800-421-6674,30,,Posted,638.19
1,8/26/2022,,POS WD  SHELL SERVICE STATION  RENO         NVUS,6,,Posted,668.19
1,8/26/2022,,POS WD SMITHS FOOD # 43 175 LEMMON DRIVE       RENO         NVUS,6.97,,Posted,674.19
1,8/26/2022,,POS WD  SQ *FIRST FRUITS SUSTAIFallon       NVUS,1,,Posted,681.16
1,8/26/2022,,POS WD  SQ *PREMA FARM         Reno         NVUS,5,,Posted,682.16
1,8/25/2022,,POS WD  VENMO*                 Visa Direct  NYUS,650,,Posted,687.16
1,8/25/2022,,POS WD  VZWRLSS*APOCC VISW     800-922-0204 FLUS,106.7,,Posted,1337.16
1,8/25/2022,,External DP VENMO  - CASHOUT,,69.54,Posted,1443.86
1,8/25/2022,,External DP NV GAME DESIGN L  - PAYROLL,,564.74,Posted,1374.32
1,8/25/2022,,POS WD  DUNKIN #353932 Q35     SPARKS       NVUS,11.53,,Posted,809.58
1,8/24/2022,,POS WD  AMAZON.COM             SEATTLE      WAUS,70.77,,Posted,821.11
1,8/24/2022,,External DP PAYPAL TRANSFER - TRANSFER,,162,Posted,891.88
1,8/24/2022,,POS WD  PP*DUTCH BROS NV0601   GRANTS PASS  ORUS,2.86,,Posted,729.88
1,8/23/2022,,External DP GreaterNevada  - E-DEPOSIT,,628.01,Posted,732.74
1,8/23/2022,,POS WD  VENMO*                 Visa Direct  NYUS,41.55,,Posted,104.73
1,8/22/2022,,External WD FARMERS INS  - EFT PYMT,17.21,,Posted,146.28
1,8/21/2022,,POS WD  IN N OUT BURGER 187    CARSON CITY  NVUS,5.41,,Posted,163.49
1,8/21/2022,,POS WD  Roku for WarnerMedia Gl816-2728107  DEUS,9.99,,Posted,168.9
1,8/20/2022,,POS WD  VENMO*                 Visa Direct  NYUS,124,,Posted,178.89
1,8/20/2022,,POS WD MCDONALD'S F10489 120 LEMMON DR          RENO         NVUS,1.08,,Posted,302.89
1,8/19/2022,,POS WD  DUTCH BROS             541-955-4700 ORUS,15,,Posted,303.97
1,8/18/2022,,POS WD  DUTCH BROS             541-955-4700 ORUS,10,,Posted,318.97
1,8/17/2022,,POS WD SMITHS FOOD # 43 175 LEMMON DRIVE       RENO         NVUS,26.61,,Posted,328.97
1,8/17/2022,,External DP VENMO  - CASHOUT,,10,Posted,355.58
1,8/17/2022,,POS WD  APPLE.COM/BILL         866-712-7753 CAUS,2.99,,Posted,345.58
1,8/17/2022,,POS WD  GLI*GERBER LIFE INSUR  800-704-2180 MIUS,69.96,,Posted,348.57
1,8/16/2022,,POS WD  Adobe Inc              800-8336687  CAUS,29.99,,Posted,418.53
1,8/16/2022,,POS WD  DUTCH BROS             541-955-4700 ORUS,10,,Posted,448.52
1,8/16/2022,,External DP VENMO  - CASHOUT,,90,Posted,458.52
1,8/16/2022,,POS WD  VENMO*                 Visa Direct  NYUS,72.72,,Posted,368.52
1,8/14/2022,,POS WD  SPOTIFY                877-778-1161 NYUS,9.99,,Posted,441.24
1,8/13/2022,,POS WD SMITHS FOOD # 43 175 LEMMON DRIVE       RENO         NVUS,25.99,,Posted,451.23
1,8/12/2022,,POS WD  DD DOORDASH GOLDENFLO  855-973-1040 CAUS,43.28,,Posted,477.22
1,8/12/2022,,External WD DISCOVER DC PYMNTS DCIINTNET - E-PAYMENT,228,,Posted,520.5
1,8/12/2022,,POS WD  PP*DUTCH BROS NV0601   GRANTS PASS  ORUS,5.36,,Posted,748.5
1,8/11/2022,,POS WD  RAISING CANE'S 452     RENO         NVUS,10.91,,Posted,753.86
1,8/11/2022,,POS WD SAVE MART #554 RENO NV 4995 KIETZKE LANE      RENO         N,11.18,,Posted,764.77
1,8/10/2022,,POS WD  AMZN Mktp US*MI2PU69D3 Amzn.com/billWAUS,7.57,,Posted,775.95
1,8/10/2022,,External DP NV GAME DESIGN L  - PAYROLL,,682.55,Posted,783.52
1,8/8/2022,,POS WD  VENMO*                 Visa Direct  NYUS,4.57,,Posted,100.97
1,8/6/2022,,Deposit Mobile Transfer from 886610643 SAV,,50,Posted,105.54
1,8/5/2022,,POS WD SMITHS FOOD # 43 175 LEMMON DRIVE       RENO         NVUS,7.99,,Posted,55.54
1,8/5/2022,,POS WD  VENMO*                 Visa Direct  NYUS,25,,Posted,63.53
1,8/4/2022,,POS WD  WENDY'S                RENO         NVUS,1.83,,Posted,88.53
1,8/2/2022,,External WD GEICO  - PREM COLL,82.47,,Posted,90.36
1,8/2/2022,,POS WD  EIG*Hostgator.com      713-5745287  MAUS,17.95,,Posted,172.83
1,8/2/2022,,POS WD  PP*DUTCH BROS NV0601   GRANTS PASS  ORUS,1.02,,Posted,190.78
1,8/1/2022,,POS WD  VENMO*                 Visa Direct  NYUS,7.01,,Posted,191.8
1,8/1/2022,,POS WD WAL-MART #4239 250 VISTA KNOLL PARKWAYRENO         NVUS,23.54,,Posted,198.81
1,8/1/2022,,External DP FID BKG SVC LLC  - MONEYLINE,,70,Posted,222.35
1,8/1/2022,,POS WD LOWE'S #32 5075 KIETZKE LANE  US  RENO         NVUS,14.3,,Posted,152.35
1,7/31/2022,,Descriptive Deposit Cash Back Reward,,10,Posted,166.65
1,7/31/2022,,POS WD  Amazon.com*UT76X42V3   Amzn.com/billWAUS,3.99,,Posted,156.65
1,7/30/2022,,POS WD SMITHS FOOD # 43 175 LEMMON DRIVE       RENO         NVUS,10.74,,Posted,160.64
1,7/28/2022,,External WD NATL FIN SVC LLC  - EFT,0.45,,Posted,171.38
1,7/28/2022,,External DP NATL FIN SVC LLC  - EFT,,0.2,Posted,171.83
1,7/28/2022,,External DP NATL FIN SVC LLC  - EFT,,0.25,Posted,171.63
1,7/28/2022,,"External DP FISHER,MAYA PERSONAL SAVINGS - TRANSFER",,100,Posted,171.38
1,7/26/2022,,POS WD  VENMO*                 Visa Direct  NYUS,650,,Posted,71.38
1,7/26/2022,,"External DP FISHER,MAYA PERSONAL SAVINGS - TRANSFER",,100,Posted,721.38
1,7/26/2022,,External WD NV ENERGY NORTH SPPCO - SPPC PYMT,112.45,,Posted,621.38
1,7/25/2022,,POS WD  VZWRLSS*APOCC VISW     800-922-0204 FLUS,108.01,,Posted,733.83
1,7/25/2022,,External DP VENMO  - CASHOUT,,37.48,Posted,841.84
1,7/25/2022,,External DP VENMO  - CASHOUT,,37.48,Posted,804.36
1,7/25/2022,,External DP NV GAME DESIGN L  - PAYROLL,,515.21,Posted,766.88
1,7/25/2022,,POS WD  TST* WOW WOW HAWAIIAN LRENO         NVUS,8.98,,Posted,251.67
1,7/24/2022,,POS WD  VENMO*                 Visa Direct  NYUS,63.55,,Posted,260.65
1,7/23/2022,,POS WD MAVERIK #569 1391 N. MCCARRAN BLVD. RENO         NVUS,8.21,,Posted,324.2
1,7/23/2022,,POS WD SMITHS FOOD # 43 175 LEMMON DRIVE       RENO         NVUS,15.27,,Posted,332.41
1,7/21/2022,,POS WD SMITHS FOOD # 43 175 LEMMON DRIVE       RENO         NVUS,11.72,,Posted,347.68
1,7/21/2022,,POS WD  Roku for WarnerMedia Gl816-2728107  DEUS,9.99,,Posted,359.4
1,7/21/2022,,External WD DISCOVER DC PYMNTS DCIINTNET - E-PAYMENT,47.08,,Posted,369.39
1,7/20/2022,,POS WD  SQ *KEVA JUICE - NW RENReno         NVUS,5.97,,Posted,416.47
1,7/20/2022,,POS WD USPS PO 31728806 1050 N HILLS BLVD      RENO         NVUS,13.4,,Posted,422.44
1,7/20/2022,,ATM Deposit GREATER NEVADA CU 1095 N HILLS BLVD      RENO         NVUS,,50,Posted,435.84
1,7/20/2022,,External WD FARMERS INS  - EFT PYMT,17.24,,Posted,385.84
1,7/19/2022,,POS WD  RALEY S #115 1075 N HILRENO         NVUS,7.64,,Posted,403.08
1,7/18/2022,,POS WD  VENMO*                 Visa Direct  NYUS,44.07,,Posted,410.72
1,7/18/2022,,POS WD SMITHS FOOD # 43 175 LEMMON DRIVE       RENO         NVUS,12.39,,Posted,454.79
1,7/18/2022,,External WD AMERICANEXPRESS PERSONAL SAVINGS - TRANSFER,92.17,,Posted,467.18
1,7/18/2022,,POS WD  DOUGHBOYS DONUTS 2 LLC RENO         NVUS,2.95,,Posted,559.35
1,7/16/2022,,ATM Foreign Trns Fee (SYS),6,,Posted,562.3
1,7/16/2022,,POS WD APPLE COM ONE APPLE PARK WAY US  CUPERTINO    CAUS,2.99,,Posted,568.3
1,7/16/2022,,POS WD  Adobe Inc              800-8336687  CAUS,29.99,,Posted,571.29
1,7/16/2022,,POS WD  AMAZON.COM             SEATTLE      WAUS,14.89,,Posted,601.28
1,7/16/2022,,ATM Withdrawal MYNT North 340 Lemmon Dr      US  Reno         NVUS,23,,Posted,616.17
1,7/16/2022,,ATM Withdrawal MYNT North 340 Lemmon Dr      US  Reno         NVUS,103,,Posted,639.17
1,7/15/2022,,Withdrawal Internet Transfer to 886610643 SAV,23.82,,Posted,742.17
1,7/15/2022,,POS WD  WENDY'S                RENO         NVUS,2.7,,Posted,765.99
1,7/15/2022,,POS WD  SPOTIFY                877-778-1161 NYUS,9.99,,Posted,768.69
1,7/14/2022,,POS WD SMITHS FOOD # 43 175 LEMMON DRIVE       RENO         NVUS,20.24,,Posted,778.68
1,7/14/2022,,External DP VENMO  - CASHOUT,,27,Posted,798.92
1,7/13/2022,,POS WD Wal-Mart Super Center 4239 WAL-SAMS          RENO         NV,21.13,,Posted,771.92
1,7/13/2022,,POS WD  SALLY BEAUTY 103 206 LERENO         NVUS,80.96,,Posted,793.05
1,7/13/2022,,External DP PAYPAL TRANSFER - TRANSFER,,438,Posted,874.01
1,7/12/2022,,POS WD  Subway COO54992        Stead        NVUS,13.91,,Posted,436.01
1,7/12/2022,,POS WD  VENMO*                 Visa Direct  NYUS,101.79,,Posted,449.92
1,7/12/2022,,POS WD  AMAZON.COM             SEATTLE      WAUS,15.56,,Posted,551.71
1,7/11/2022,,External WD DISCOVER DC PYMNTS DCIINTNET - E-PAYMENT,300,,Posted,567.27
1,7/11/2022,,POS WD  EIG*Hostgator.com      713-5745287  MAUS,16.95,,Posted,867.27
1,7/9/2022,,POS WD SMITHS FOOD # 43 175 LEMMON DRIVE       RENO         NVUS,25.51,,Posted,884.22
1,7/9/2022,,POS WD DOLLAR TREE 1130 N HILLS BLVD STE 1RENO         NVUS,10.83,,Posted,909.73
1,7/9/2022,,POS WD MAVERIK #443 15 PANTHER DR          RENO         NVUS,66.24,,Posted,920.56
1,7/8/2022,,POS WD  IC* INSTACART          HTTPSINSTACARCAUS,53.48,,Posted,986.8
1,7/8/2022,,POS WD  AMAZON PAYMENTS        SEATTLE      WAUS,30.35,,Posted,1040.28
1,7/8/2022,,"External DP FISHER,MAYA PERSONAL SAVINGS - TRANSFER",,200,Posted,1070.63
1,7/8/2022,,External DP NV GAME DESIGN L  - PAYROLL,,850.63,Posted,870.63
1,7/7/2022,,Deposit Internet Transfer from 886610643 SAV,,20,Posted,20
1,7/6/2022,,Overdraft Protection Deposit,,3.83,Posted,0
1,7/6/2022,,External WD AMERICANEXPRESS PERSONAL SAVINGS - TRANSFER,79,,Posted,-3.83
1,7/6/2022,,POS WD  TACO BELL #35456       PHOENIX      AZUS,12.79,,Posted,75.17
1,7/6/2022,,POS WD  2LEVY@BANK1            PHOENIX      AZUS,19.21,,Posted,87.96
1,7/6/2022,,POS WD  2LEVY@BANK1            PHOENIX      AZUS,19.54,,Posted,107.17
1,7/6/2022,,POS WD GOLD STAR 2 LLC 37770 VULTURE MINE ROADWICKENBURG   AZUS,1.73,,Posted,126.71
1,7/6/2022,,POS WD  VENMO*                 Visa Direct  NYUS,63.5,,Posted,128.44
1,7/5/2022,,POS WD  SQ *ASH AVENUE COMICS &amp;Tempe        AZUS,23.77,,Posted,191.94
1,7/5/2022,,POS WD  LUSH US - 446 - SCOTTSDSCOTTSDALE   AZUS,130.69,,Posted,215.71
1,7/5/2022,,External WD GEICO  - PREM COLL,82.48,,Posted,346.4
1,7/5/2022,,POS WD  DAIRY QUEEN #13488     GLENDALE     AZUS,6.27,,Posted,428.88
1,7/4/2022,,POS WD  SQ *SHOPS AT NORTERRA  Phoenix      AZUS,18.92,,Posted,435.15
1,7/4/2022,,POS WD  TROPICAL SMOOTHIE CAFE SCOTTSDALE   AZUS,8.93,,Posted,454.07
1,7/3/2022,,POS WD  KACTUS JOCK            SCOTTSDALE   AZUS,16.2,,Posted,463
1,7/3/2022,,POS WD  VENMO*                 Visa Direct  NYUS,49.33,,Posted,479.2
1,7/2/2022,,POS WD  The Spice And Tea ExchaScottsdale   AZUS,31.32,,Posted,528.53
1,7/2/2022,,POS WD  SQ *MADHOUSE COFFEE    Las Vegas    NVUS,33.61,,Posted,559.85
1,6/30/2022,,Descriptive Deposit Cash Back Reward,,10,Posted,593.46
1,6/29/2022,,POS WD SMITHS FOOD # 43 175 LEMMON DRIVE       RENO         NVUS,33.47,,Posted,583.46
1,6/28/2022,,"External DP FISHER,MAYA PERSONAL SAVINGS - TRANSFER",,400,Posted,616.93
1,6/28/2022,,External DP VENMO  - CASHOUT,,36.25,Posted,216.93
1,6/27/2022,,POS WD SMITHS FOOD # 43 175 LEMMON DRIVE       RENO         NVUS,22.27,,Posted,180.68
1,6/27/2022,,POS WD SMITHS FOOD # 43 175 LEMMON DRIVE       RENO         NVUS,31.32,,Posted,202.95
1,6/27/2022,,External WD DISCOVER DC PYMNTS DCIINTNET - E-PAYMENT,263.14,,Posted,234.27
1,6/27/2022,,External WD NV ENERGY NORTH SPPCO - SPPC PYMT,108.75,,Posted,497.41
1,6/26/2022,,POS WD  PHO 777                RENO         NVUS,28.24,,Posted,606.16
1,6/26/2022,,POS WD  AMZN Mktp US*SS44775M3 Amzn.com/billWAUS,5.32,,Posted,634.4
1,6/25/2022,,POS WD  VZWRLSS*APOCC VISW     800-922-0204 FLUS,90.24,,Posted,639.72
1,6/24/2022,,External DP GreaterNevada  - E-DEPOSIT,,100,Posted,729.96
1,6/24/2022,,POS WD  AMAZON.COM             SEATTLE      WAUS,43.3,,Posted,629.96
1,6/24/2022,,POS WD  VENMO*                 Visa Direct  NYUS,650,,Posted,673.26
1,6/24/2022,,External DP NV GAME DESIGN L  - PAYROLL,,859.09,Posted,1323.26
1,6/24/2022,,POS WD  SQ *TUKTUK YUMYUM FROZESparks       NVUS,9.85,,Posted,464.17
1,6/24/2022,,POS WD  SQ *LITTLE FISH COMPANYAuburn       CAUS,18.71,,Posted,474.02
1,6/24/2022,,POS WD  SQ *VILLAGE FARMERS MARReno         NVUS,13,,Posted,492.73
1,6/22/2022,,POS WD  UNR PAYBYPHONE         775-784-4654 NVUS,2.25,,Posted,505.73
1,6/22/2022,,POS WD  UNR PAYBYPHONE         775-784-4654 NVUS,2.25,,Posted,507.98
1,6/22/2022,,POS WD WAL-MART #4239 250 VISTA KNOLL PARKWAYRENO         NVUS,28.21,,Posted,510.23
1,6/22/2022,,External DP PAYPAL TRANSFER - TRANSFER,,50,Posted,538.44
1,6/21/2022,,External WD DISCOVER DC PYMNTS DCIINTNET - E-PAYMENT,550,,Posted,488.44
1,6/21/2022,,External WD FARMERS INS  - EFT PYMT,17.21,,Posted,1038.44
1,6/20/2022,,POS WD  Roku for WarnerMedia Gl816-2728107  DEUS,9.99,,Posted,1055.65
1,6/17/2022,,POS WD SMITHS FOOD # 43 175 LEMMON DRIVE       RENO         NVUS,25.22,,Posted,1065.64
1,6/17/2022,,"External DP FISHER,MAYA PERSONAL SAVINGS - TRANSFER",,550,Posted,1090.86
1,6/17/2022,,POS WD  APPLE.COM/BILL         866-712-7753 CAUS,2.99,,Posted,540.86
1,6/16/2022,,POS WD  Subway COO54992        Stead        NVUS,14.78,,Posted,543.85
1,6/16/2022,,POS WD  VENMO*                 Visa Direct  NYUS,45.75,,Posted,558.63
1,6/16/2022,,"POS WD Adobe Park Avenue,345        San Jose     CAUS",29.99,,Posted,604.38
1,6/14/2022,,External DP GreaterNevada  - E-DEPOSIT,,22,Posted,634.37
1,6/14/2022,,POS WD  Spotify USA            877-7781161  NYUS,9.99,,Posted,612.37
1,6/14/2022,,POS WD  VENMO*                 Visa Direct  NYUS,60,,Posted,622.36
1,6/11/2022,,POS WD  EIG*Hostgator.com      713-5745287  MAUS,16.95,,Posted,682.36
1,6/10/2022,,POS WD  VENMO*                 Visa Direct  NYUS,40.66,,Posted,699.31
1,6/10/2022,,POS WD  VENMO*                 Visa Direct  NYUS,180.84,,Posted,739.97
1,6/10/2022,,External DP NV GAME DESIGN L  - PAYROLL,,829.45,Posted,920.81
1,6/9/2022,,ATM Foreign Trns Fee (SYS),3,,Posted,91.36
1,6/9/2022,,POS WD  IN N OUT BURGER 186    RENO         NVUS,13.53,,Posted,94.36
1,6/9/2022,,ATM Withdrawal MYNT North 340 Lemmon Dr      US  Reno         NVUS,43,,Posted,107.89
1,6/8/2022,,External DP GreaterNevada  - E-DEPOSIT,,100,Posted,150.89
1,6/7/2022,,POS WD  VENMO*                 Visa Direct  NYUS,142.43,,Posted,50.89
1,6/7/2022,,"External DP FISHER,MAYA PERSONAL SAVINGS - TRANSFER",,142.43,Posted,193.32
1,6/6/2022,,External WD DISCOVER DC PYMNTS DCIINTNET - E-PAYMENT,529,,Posted,50.89
1,6/4/2022,,POS WD  WALGREENS STORE 305 LEMRENO         NVUS,42.95,,Posted,579.89
1,6/3/2022,,POS WD  VENMO*                 Visa Direct  NYUS,25.47,,Posted,622.84
1,6/3/2022,,POS WD  VENMO*                 Visa Direct  NYUS,24,,Posted,648.31
1,6/2/2022,,External WD GEICO  - PREM COLL,82.48,,Posted,672.31
1,6/2/2022,,"External DP FISHER,MAYA PERSONAL SAVINGS - TRANSFER",,529,Posted,754.79
1,6/1/2022,,External WD NV ENERGY NORTH SPPCO - SPPC PYMT,81.69,,Posted,225.79
1,6/1/2022,,POS WD  VENMO*                 Visa Direct  NYUS,88.66,,Posted,307.48
1,6/1/2022,,POS WD  VENMO*                 Visa Direct  NYUS,8.7,,Posted,396.14
1,5/31/2022,,Descriptive Deposit Cash Back Reward,,10,Posted,404.84
1,5/31/2022,,External WD DISCOVER DC PYMNTS DCIINTNET - E-PAYMENT,300,,Posted,394.84
1,5/31/2022,,External DP VENMO  - CASHOUT,,27.23,Posted,694.84
1,5/31/2022,,External DP VENMO  - CASHOUT,,27.23,Posted,667.61
1,5/31/2022,,External DP PAYPAL TRANSFER - TRANSFER,,150,Posted,640.38
1,5/27/2022,,External WD AMERICANEXPRESS PERSONAL SAVINGS - TRANSFER,43,,Posted,490.38
1,5/27/2022,,Withdrawal Internet Transfer to 886610643 SAV,20,,Posted,533.38
1,5/26/2022,,POS WD  TACO BELL #027362      RENO         NVUS,20.19,,Posted,553.38
1,5/25/2022,,POS WD  VENMO*                 Visa Direct  NYUS,650,,Posted,573.57
1,5/25/2022,,POS WD  VZWRLSS*APOCC VISW     800-922-0204 FLUS,71.06,,Posted,1223.57
1,5/25/2022,,External DP VENMO  - CASHOUT,,65,Posted,1294.63
1,5/25/2022,,External DP NV GAME DESIGN L  - PAYROLL,,891.73,Posted,1229.63
1,5/25/2022,,POS WD  APPLE.COM/BILL         866-712-7753 CAUS,39.99,,Posted,337.9
1,5/24/2022,,POS WD  CHEVRON/SRY INDUSTRIES LOVELOCK     NVUS,29.31,,Posted,377.89
1,5/24/2022,,POS WD MCDONALD'S F10489 120 LEMMON DR          RENO         NVUS,9.83,,Posted,407.2
1,5/24/2022,,POS WD  PP*DUTCH BROS NV0601   GRANTS PASS  ORUS,6.32,,Posted,417.03
1,5/23/2022,,POS WD FRANCESCA'S B216 5365 MEADOWOOD MAL     RENO         NVUS,27.07,,Posted,423.35
1,5/23/2022,,POS WD  VENMO*                 Visa Direct  NYUS,25,,Posted,450.42
1,5/23/2022,,ATM Deposit GREATER NEVADA CU 1095 N HILLS BLVD      RENO         NVUS,,269,Posted,475.42
1,5/22/2022,,POS WD  AMAZON.COM             SEATTLE      WAUS,181.87,,Posted,206.42
1,5/22/2022,,POS WD SMITHS FOOD # 43 175 LEMMON DRIVE       RENO         NVUS,5.39,,Posted,388.29
1,5/22/2022,,POS WD  VENMO*                 Visa Direct  NYUS,10,,Posted,393.68
1,5/20/2022,,External WD FARMERS INS  - EFT PYMT,17.21,,Posted,403.68
1,5/19/2022,,External DP VENMO  - CASHOUT,,20,Posted,420.89
1,5/18/2022,,External WD DISCOVER DC PYMNTS DCIINTNET - E-PAYMENT,78,,Posted,400.89
1,5/18/2022,,POS WD  APPLE.COM/BILL         408-974-1010 CAUS,2.99,,Posted,478.89
1,5/16/2022,,POS WD  Adobe Inc              800-8336687  CAUS,29.99,,Posted,481.88
1,5/16/2022,,External WD DISCOVER DC PYMNTS DCIINTNET - E-PAYMENT,356.18,,Posted,511.87
1,5/14/2022,,POS WD  Spotify USA            877-7781161  NYUS,9.99,,Posted,868.05
1,5/13/2022,,ATM Foreign Trns Fee (SYS),3,,Posted,878.04
1,5/13/2022,,ATM Withdrawal PAI ISO 675 S VIRGINIA ST      RENO         NVUS,103,,Posted,881.04
1,5/11/2022,,POS WD  VENMO*                 Visa Direct  NYUS,35.88,,Posted,984.04
1,5/11/2022,,POS WD  EIG*Hostgator.com      713-5745287  MAUS,16.95,,Posted,1019.92
1,5/10/2022,,External DP NV GAME DESIGN L  - PAYROLL,,710.39,Posted,1036.87
1,5/10/2022,,POS WD  PP*DUTCHBROSLL         GRANTS PASS  ORUS,3.61,,Posted,326.48
1,5/9/2022,,External DP GreaterNevada  - E-DEPOSIT,,25,Posted,330.09
1,5/9/2022,,External DP GreaterNevada  - E-DEPOSIT,,100,Posted,305.09
1,5/9/2022,,External DP GreaterNevada  - E-DEPOSIT,,100,Posted,205.09
1,5/7/2022,,POS WD SMITHS FOOD # 43 175 LEMMON DRIVE       RENO         NVUS,5.07,,Posted,105.09
1,5/7/2022,,POS WD  VENMO*                 Visa Direct  NYUS,40,,Posted,110.16
1,5/6/2022,,POS WD  RAISING CANE'S 449     SPARKS       NVUS,10.49,,Posted,150.16
1,5/6/2022,,POS WD  GALAXY THEATRE LEGENDS SPARKS       NVUS,22,,Posted,160.65
1,5/5/2022,,ATM Deposit GREATER NEVADA CU 1095 N HILLS BLVD      RENO         NVUS,,53,Posted,182.65
1,5/4/2022,,POS WD  UNR PAYBYPHONE         775-784-4654 NVUS,4.25,,Posted,129.65
1,5/4/2022,,POS WD  UNR PAYBYPHONE         775-784-4654 NVUS,8.25,,Posted,133.9
1,5/3/2022,,Withdrawal,100,,Posted,142.15
1,5/3/2022,,Deposit,,7.35,Posted,242.15
1,5/3/2022,,POS WD  UNR PAYBYPHONE         775-784-4654 NVUS,6.25,,Posted,234.8
1,5/2/2022,,External DP VENMO  - CASHOUT,,57.2,Posted,241.05
1,4/30/2022,,Descriptive Deposit Cash Back Reward,,10,Posted,183.85
1,4/29/2022,,POS WD  UNR PAYBYPHONE         775-784-4654 NVUS,6.25,,Posted,173.85
1,4/27/2022,,POS WD  UNR PAYBYPHONE         775-784-4654 NVUS,8.25,,Posted,180.1
1,4/27/2022,,"External DP FISHER,MAYA PERSONAL SAVINGS - TRANSFER",,150,Posted,188.35
1,4/27/2022,,POS WD  VENMO*                 Visa Direct  NYUS,650,,Posted,38.35
1,4/27/2022,,POS WD  PANERA BREAD #203154 P RENO         NVUS,13.28,,Posted,688.35
1,4/26/2022,,External DP NV GAME DESIGN L  - PAYROLL,,579.17,Posted,701.63
1,4/25/2022,,POS WD SMITHS FOOD # 43 175 LEMMON DRIVE       RENO         NVUS,55.22,,Posted,122.46
1,4/25/2022,,POS WD  SHELL OIL 57429902208  RENO         NVUS,8,,Posted,177.68
1,4/25/2022,,POS WD  VZWRLSS*APOCC VISW     800-922-0204 FLUS,71.06,,Posted,185.68
1,4/25/2022,,External WD DISCOVER DC PYMNTS DCIINTNET - E-PAYMENT,356,,Posted,256.74
1,4/25/2022,,POS WD  EGG ROLL KING          RENO         NVUS,22.95,,Posted,612.74
1,4/24/2022,,POS WD  MCDONALD'S F10489      RENO         NVUS,1.08,,Posted,635.69
1,4/23/2022,,POS WD  MCDONALD'S F10489      RENO         NVUS,10.14,,Posted,636.77
1,4/22/2022,,POS WD SMITHS FOOD # 43 175 LEMMON DRIVE       RENO         NVUS,31.26,,Posted,646.91
1,4/22/2022,,POS WD  UNR PAYBYPHONE         775-784-4654 NVUS,7.25,,Posted,678.17
1,4/22/2022,,POS WD USPS PO 31728806 1050 N HILLS BLVD      RENO         NVUS,60.6,,Posted,685.42
1,4/20/2022,,POS WD  UNR PAYBYPHONE         775-784-4654 NVUS,6.25,,Posted,746.02
1,4/20/2022,,POS WD  UNR PAYBYPHONE         775-784-4654 NVUS,6.25,,Posted,752.27
1,4/20/2022,,External WD FARMERS INS  - EFT PYMT,17.21,,Posted,758.52
1,4/19/2022,,POS WD  UNR PAYBYPHONE         775-784-4654 NVUS,4.25,,Posted,775.73
1,4/19/2022,,POS WD  UNR PAYBYPHONE         775-784-4654 NVUS,4.25,,Posted,779.98
1,4/18/2022,,POS WD  NETFLIX.COM            NETFLIX.COM  CAUS,9.99,,Posted,784.23
1,4/17/2022,,POS WD  APPLE COM BILL         CUPERTINO    CAUS,2.86,,Posted,794.22
1,4/16/2022,,POS WD  UNR PAYBYPHONE         775-784-4654 NVUS,8.25,,Posted,797.08
1,4/16/2022,,"POS WD Adobe Park Avenue,345        San Jose     CAUS",29.99,,Posted,805.33
1,4/15/2022,,POS WD SMITHS FOOD # 43 175 LEMMON DRIVE       RENO         NVUS,39.11,,Posted,835.32
1,4/15/2022,,POS WD SMITHS FOOD # 43 175 LEMMON DRIVE       RENO         NVUS,7.25,,Posted,874.43
1,4/15/2022,,ATM Deposit GREATER NEVADA CU 1095 N HILLS BLVD      RENO         NVUS,,716.25,Posted,881.68
1,4/15/2022,,POS WD  UNR PAYBYPHONE         775-784-4654 NVUS,6.25,,Posted,165.43
1,4/15/2022,,POS WD  EQT*Hometown Health Pla775-9823232  NVUS,12.73,,Posted,171.68
1,4/14/2022,,POS WD  Spotify USA            877-7781161  NYUS,9.99,,Posted,184.41
1,4/13/2022,,POS WD  UNR PAYBYPHONE         775-784-4654 NVUS,6.25,,Posted,194.4
1,4/12/2022,,ATM Withdrawal GREATER NEVADA CU 1095 N HILLS BLVD      RENO         NVUS,120,,Posted,200.65
1,4/12/2022,,POS WD  WINCO FOODS #17 2855 N Reno         NVUS,127.09,,Posted,320.65
1,4/12/2022,,POS WD  VENMO*                 Visa Direct  NYUS,40,,Posted,447.74
1,4/12/2022,,POS WD  VENMO*                 Visa Direct  NYUS,19,,Posted,487.74
1,4/12/2022,,External DP VENMO  - CASHOUT,,60,Posted,506.74
1,4/12/2022,,External DP VENMO  - CASHOUT,,109,Posted,446.74
1,4/12/2022,,"External DP FISHER,MAYA PERSONAL SAVINGS - TRANSFER",,300,Posted,337.74
1,4/11/2022,,External WD NV ENERGY NORTH SPPCO - SPPC PYMT,95.28,,Posted,37.74
1,4/11/2022,,External WD GEICO  - GEICO PYMT,82.48,,Posted,133.02
1,4/11/2022,,POS WD  EIG*Hostgator.com      713-5745287  MAUS,16.95,,Posted,215.5
1,4/9/2022,,POS WD SMITHS FOOD # 43 175 LEMMON DRIVE       RENO         NVUS,20.94,,Posted,232.45
1,4/8/2022,,External DP VENMO  - CASHOUT,,31.76,Posted,253.39
1,4/7/2022,,POS WD  PIZZA HUT 30577        https://ipchaNVUS,30.66,,Posted,221.63
1,4/6/2022,,POS WD  THE EDDY               RENO         NVUS,3,,Posted,252.29
1,4/6/2022,,External WD DISCOVER DC PYMNTS DCIINTNET - E-PAYMENT,389.49,,Posted,255.29
1,4/6/2022,,POS WD  SQ *BLACK ROCK DESSERTSReno         NVUS,13,,Posted,644.78
1,4/5/2022,,POS WD  UNR PAYBYPHONE         775-784-4654 NVUS,4.25,,Posted,657.78
1,4/5/2022,,POS WD  PANERA BREAD #203154 K RENO         NVUS,9.15,,Posted,662.03
1,4/5/2022,,"External DP FISHER,MAYA PERSONAL SAVINGS - TRANSFER",,600,Posted,671.18
1,4/4/2022,,POS WD  VENMO                  855-812-4430 NYUS,650,,Posted,71.18
1,4/4/2022,,POS WD  VENMO                  855-812-4430 NYUS,20,,Posted,721.18
1,4/4/2022,,POS WD  VENMO                  855-812-4430 NYUS,15,,Posted,741.18
1,4/4/2022,,External DP AMERICANEXPRESS PERSONAL SAVINGS - AXP TEST,,0.06,Posted,756.18
1,4/4/2022,,External DP AMERICANEXPRESS PERSONAL SAVINGS - AXP TEST,,0.17,Posted,756.12
1,4/2/2022,,POS WD SMITHS FOOD # 43 175 LEMMON DRIVE       RENO         NVUS,23.43,,Posted,755.95
1,4/1/2022,,New Account Deposit,,779.38,Posted,779.38